Team,Season,Season End Year,Points,Cumulative Points,Goals For,Cumulative Goals For,Goals Against,Cumulative Goals Against,Goal Difference,Cumulative Goal Difference
Everton,2002-03,2003,59,527,48,527,49,587,-1,-60
Everton,2010-11,2011,54,978,51,924,45,939,6,-15
Everton,2003-04,2004,39,566,45,572,57,644,-12,-72
Everton,2007-08,2008,65,800,55,758,33,808,22,-50
Everton,1995-96,1996,61,208,64,203,44,213,20,-10
Everton,2015-16,2016,47,1263,59,1197,55,1163,4,34
Everton,1996-97,1997,42,250,44,247,57,270,-13,-23
Everton,2005-06,2006,50,677,34,651,49,739,-15,-88
Everton,1992-93,1993,53,53,53,53,55,55,-2,-2
Everton,2017-18,2018,49,1373,44,1303,58,1265,-14,38
Everton,2021-22,2022,39,1574,43,1491,66,1481,-23,10
Everton,2012-13,2013,63,1097,55,1029,40,1019,15,10
Everton,1993-94,1994,44,97,42,95,63,118,-21,-23
Everton,2004-05,2005,61,627,45,617,46,690,-1,-73
Everton,2008-09,2009,63,863,55,813,37,845,18,-32
Everton,1994-95,1995,50,147,44,139,51,169,-7,-30
Everton,1999-00,2000,50,383,59,389,49,422,10,-33
Everton,2020-21,2021,59,1535,47,1448,48,1415,-1,33
Everton,2009-10,2010,61,924,60,873,49,894,11,-21
Everton,2000-01,2001,42,425,45,434,59,481,-14,-47
Everton,2013-14,2014,72,1169,61,1090,39,1058,22,32
Everton,2001-02,2002,43,468,45,479,57,538,-12,-59
Everton,1997-98,1998,40,290,41,288,56,326,-15,-38
Everton,2019-20,2020,49,1476,44,1401,56,1367,-12,34
Everton,2006-07,2007,58,735,52,703,36,775,16,-72
Everton,2022-23,2023,36,1610,34,1525,57,1538,-23,-13
Everton,2011-12,2012,56,1034,50,974,40,979,10,-5
Everton,2018-19,2019,54,1427,54,1357,46,1311,8,46
Everton,2014-15,2015,47,1216,48,1138,50,1108,-2,30
Everton,2016-17,2017,61,1324,62,1259,44,1207,18,52
Everton,1998-99,1999,43,333,42,330,47,373,-5,-43
Everton,2023-24,2024,48,1658,40,1565,51,1589,-11,-24
Sunderland,2002-03,2003,19,214,21,188,65,266,-44,-78
Sunderland,2010-11,2011,47,395,45,377,56,560,-11,-183
Sunderland,2003-04,2004,0,214,0,188,0,266,0,-78
Sunderland,2007-08,2008,39,268,36,250,59,394,-23,-144
Sunderland,1995-96,1996,0,0,0,0,0,0,0,0
Sunderland,2015-16,2016,39,594,48,583,62,835,-14,-252
Sunderland,1996-97,1997,40,40,35,35,53,53,-18,-18
Sunderland,2005-06,2006,15,229,26,214,69,335,-43,-121
Sunderland,1992-93,1993,0,0,0,0,0,0,0,0
Sunderland,2017-18,2018,0,618,0,612,0,904,0,-292
Sunderland,2021-22,2022,0,618,0,612,0,904,0,-292
Sunderland,2012-13,2013,39,479,41,463,54,660,-13,-197
Sunderland,1993-94,1994,0,0,0,0,0,0,0,0
Sunderland,2004-05,2005,0,214,0,188,0,266,0,-78
Sunderland,2008-09,2009,36,304,34,284,54,448,-20,-164
Sunderland,1994-95,1995,0,0,0,0,0,0,0,0
Sunderland,1999-00,2000,58,98,57,92,56,109,1,-17
Sunderland,2020-21,2021,0,618,0,612,0,904,0,-292
Sunderland,2009-10,2010,44,348,48,332,56,504,-8,-172
Sunderland,2000-01,2001,57,155,46,138,41,150,5,-12
Sunderland,2013-14,2014,38,517,41,504,60,720,-19,-216
Sunderland,2001-02,2002,40,195,29,167,51,201,-22,-34
Sunderland,1997-98,1998,0,40,0,35,0,53,0,-18
Sunderland,2019-20,2020,0,618,0,612,0,904,0,-292
Sunderland,2006-07,2007,0,229,0,214,0,335,0,-121
Sunderland,2022-23,2023,0,618,0,612,0,904,0,-292
Sunderland,2011-12,2012,45,440,45,422,46,606,-1,-184
Sunderland,2018-19,2019,0,618,0,612,0,904,0,-292
Sunderland,2014-15,2015,38,555,31,535,53,773,-22,-238
Sunderland,2016-17,2017,24,618,29,612,69,904,-40,-292
Sunderland,1998-99,1999,0,40,0,35,0,53,0,-18
Sunderland,2023-24,2024,0,618,0,612,0,904,0,-292
Birmingham City,2002-03,2003,48,48,41,41,49,49,-8,-8
Birmingham City,2010-11,2011,39,301,37,273,58,360,-21,-87
Birmingham City,2003-04,2004,50,98,43,84,48,97,-5,-13
Birmingham City,2007-08,2008,35,212,46,198,62,255,-16,-57
Birmingham City,1995-96,1996,0,0,0,0,0,0,0,0
Birmingham City,2015-16,2016,0,301,0,273,0,360,0,-87
Birmingham City,1996-97,1997,0,0,0,0,0,0,0,0
Birmingham City,2005-06,2006,34,177,28,152,50,193,-22,-41
Birmingham City,1992-93,1993,0,0,0,0,0,0,0,0
Birmingham City,2017-18,2018,0,301,0,273,0,360,0,-87
Birmingham City,2021-22,2022,0,301,0,273,0,360,0,-87
Birmingham City,2012-13,2013,0,301,0,273,0,360,0,-87
Birmingham City,1993-94,1994,0,0,0,0,0,0,0,0
Birmingham City,2004-05,2005,45,143,40,124,46,143,-6,-19
Birmingham City,2008-09,2009,0,212,0,198,0,255,0,-57
Birmingham City,1994-95,1995,0,0,0,0,0,0,0,0
Birmingham City,1999-00,2000,0,0,0,0,0,0,0,0
Birmingham City,2020-21,2021,0,301,0,273,0,360,0,-87
Birmingham City,2009-10,2010,50,262,38,236,47,302,-9,-66
Birmingham City,2000-01,2001,0,0,0,0,0,0,0,0
Birmingham City,2013-14,2014,0,301,0,273,0,360,0,-87
Birmingham City,2001-02,2002,0,0,0,0,0,0,0,0
Birmingham City,1997-98,1998,0,0,0,0,0,0,0,0
Birmingham City,2019-20,2020,0,301,0,273,0,360,0,-87
Birmingham City,2006-07,2007,0,177,0,152,0,193,0,-41
Birmingham City,2022-23,2023,0,301,0,273,0,360,0,-87
Birmingham City,2011-12,2012,0,301,0,273,0,360,0,-87
Birmingham City,2018-19,2019,0,301,0,273,0,360,0,-87
Birmingham City,2014-15,2015,0,301,0,273,0,360,0,-87
Birmingham City,2016-17,2017,0,301,0,273,0,360,0,-87
Birmingham City,1998-99,1999,0,0,0,0,0,0,0,0
Birmingham City,2023-24,2024,0,301,0,273,0,360,0,-87
Wolves,2002-03,2003,0,0,0,0,0,0,0,0
Wolves,2010-11,2011,40,111,46,116,66,199,-20,-83
Wolves,2003-04,2004,33,33,38,38,77,77,-39,-39
Wolves,2007-08,2008,0,33,0,38,0,77,0,-39
Wolves,1995-96,1996,0,0,0,0,0,0,0,0
Wolves,2015-16,2016,0,136,0,156,0,281,0,-125
Wolves,1996-97,1997,0,0,0,0,0,0,0,0
Wolves,2005-06,2006,0,33,0,38,0,77,0,-39
Wolves,1992-93,1993,0,0,0,0,0,0,0,0
Wolves,2017-18,2018,0,136,0,156,0,281,0,-125
Wolves,2021-22,2022,51,348,38,328,43,462,-5,-134
Wolves,2012-13,2013,0,136,0,156,0,281,0,-125
Wolves,1993-94,1994,0,0,0,0,0,0,0,0
Wolves,2004-05,2005,0,33,0,38,0,77,0,-39
Wolves,2008-09,2009,0,33,0,38,0,77,0,-39
Wolves,1994-95,1995,0,0,0,0,0,0,0,0
Wolves,1999-00,2000,0,0,0,0,0,0,0,0
Wolves,2020-21,2021,45,297,36,290,52,419,-16,-129
Wolves,2009-10,2010,38,71,32,70,56,133,-24,-63
Wolves,2000-01,2001,0,0,0,0,0,0,0,0
Wolves,2013-14,2014,0,136,0,156,0,281,0,-125
Wolves,2001-02,2002,0,0,0,0,0,0,0,0
Wolves,1997-98,1998,0,0,0,0,0,0,0,0
Wolves,2019-20,2020,59,252,51,254,40,367,11,-113
Wolves,2006-07,2007,0,33,0,38,0,77,0,-39
Wolves,2022-23,2023,41,389,31,359,58,520,-27,-161
Wolves,2011-12,2012,25,136,40,156,82,281,-42,-125
Wolves,2018-19,2019,57,193,47,203,46,327,1,-124
Wolves,2014-15,2015,0,136,0,156,0,281,0,-125
Wolves,2016-17,2017,0,136,0,156,0,281,0,-125
Wolves,1998-99,1999,0,0,0,0,0,0,0,0
Wolves,2023-24,2024,46,435,50,409,65,585,-15,-176
Wimbledon,2002-03,2003,0,391,0,384,0,472,0,-88
Wimbledon,2010-11,2011,0,391,0,384,0,472,0,-88
Wimbledon,2003-04,2004,0,391,0,384,0,472,0,-88
Wimbledon,2007-08,2008,0,391,0,384,0,472,0,-88
Wimbledon,1995-96,1996,41,216,55,215,70,243,-15,-28
Wimbledon,2015-16,2016,0,391,0,384,0,472,0,-88
Wimbledon,1996-97,1997,56,272,49,264,46,289,3,-25
Wimbledon,2005-06,2006,0,391,0,384,0,472,0,-88
Wimbledon,1992-93,1993,54,54,56,56,55,55,1,1
Wimbledon,2017-18,2018,0,391,0,384,0,472,0,-88
Wimbledon,2021-22,2022,0,391,0,384,0,472,0,-88
Wimbledon,2012-13,2013,0,391,0,384,0,472,0,-88
Wimbledon,1993-94,1994,65,119,56,112,53,108,3,4
Wimbledon,2004-05,2005,0,391,0,384,0,472,0,-88
Wimbledon,2008-09,2009,0,391,0,384,0,472,0,-88
Wimbledon,1994-95,1995,56,175,48,160,65,173,-17,-13
Wimbledon,1999-00,2000,33,391,46,384,74,472,-28,-88
Wimbledon,2020-21,2021,0,391,0,384,0,472,0,-88
Wimbledon,2009-10,2010,0,391,0,384,0,472,0,-88
Wimbledon,2000-01,2001,0,391,0,384,0,472,0,-88
Wimbledon,2013-14,2014,0,391,0,384,0,472,0,-88
Wimbledon,2001-02,2002,0,391,0,384,0,472,0,-88
Wimbledon,1997-98,1998,44,316,34,298,46,335,-12,-37
Wimbledon,2019-20,2020,0,391,0,384,0,472,0,-88
Wimbledon,2006-07,2007,0,391,0,384,0,472,0,-88
Wimbledon,2022-23,2023,0,391,0,384,0,472,0,-88
Wimbledon,2011-12,2012,0,391,0,384,0,472,0,-88
Wimbledon,2018-19,2019,0,391,0,384,0,472,0,-88
Wimbledon,2014-15,2015,0,391,0,384,0,472,0,-88
Wimbledon,2016-17,2017,0,391,0,384,0,472,0,-88
Wimbledon,1998-99,1999,42,358,40,338,63,398,-23,-60
Wimbledon,2023-24,2024,0,391,0,384,0,472,0,-88
Nott'ham Forest,2002-03,2003,0,239,0,229,0,287,0,-58
Nott'ham Forest,2010-11,2011,0,239,0,229,0,287,0,-58
Nott'ham Forest,2003-04,2004,0,239,0,229,0,287,0,-58
Nott'ham Forest,2007-08,2008,0,239,0,229,0,287,0,-58
Nott'ham Forest,1995-96,1996,58,175,50,163,54,159,-4,4
Nott'ham Forest,2015-16,2016,0,239,0,229,0,287,0,-58
Nott'ham Forest,1996-97,1997,34,209,31,194,59,218,-28,-24
Nott'ham Forest,2005-06,2006,0,239,0,229,0,287,0,-58
Nott'ham Forest,1992-93,1993,40,40,41,41,62,62,-21,-21
Nott'ham Forest,2017-18,2018,0,239,0,229,0,287,0,-58
Nott'ham Forest,2021-22,2022,0,239,0,229,0,287,0,-58
Nott'ham Forest,2012-13,2013,0,239,0,229,0,287,0,-58
Nott'ham Forest,1993-94,1994,0,40,0,41,0,62,0,-21
Nott'ham Forest,2004-05,2005,0,239,0,229,0,287,0,-58
Nott'ham Forest,2008-09,2009,0,239,0,229,0,287,0,-58
Nott'ham Forest,1994-95,1995,77,117,72,113,43,105,29,8
Nott'ham Forest,1999-00,2000,0,239,0,229,0,287,0,-58
Nott'ham Forest,2020-21,2021,0,239,0,229,0,287,0,-58
Nott'ham Forest,2009-10,2010,0,239,0,229,0,287,0,-58
Nott'ham Forest,2000-01,2001,0,239,0,229,0,287,0,-58
Nott'ham Forest,2013-14,2014,0,239,0,229,0,287,0,-58
Nott'ham Forest,2001-02,2002,0,239,0,229,0,287,0,-58
Nott'ham Forest,1997-98,1998,0,209,0,194,0,218,0,-24
Nott'ham Forest,2019-20,2020,0,239,0,229,0,287,0,-58
Nott'ham Forest,2006-07,2007,0,239,0,229,0,287,0,-58
Nott'ham Forest,2022-23,2023,38,277,38,267,68,355,-30,-88
Nott'ham Forest,2011-12,2012,0,239,0,229,0,287,0,-58
Nott'ham Forest,2018-19,2019,0,239,0,229,0,287,0,-58
Nott'ham Forest,2014-15,2015,0,239,0,229,0,287,0,-58
Nott'ham Forest,2016-17,2017,0,239,0,229,0,287,0,-58
Nott'ham Forest,1998-99,1999,30,239,35,229,69,287,-34,-58
Nott'ham Forest,2023-24,2024,36,313,49,316,67,422,-18,-106
Bolton,2002-03,2003,44,153,41,165,51,245,-10,-80
Bolton,2010-11,2011,46,539,52,529,56,668,-4,-139
Bolton,2003-04,2004,53,206,48,213,56,301,-8,-88
Bolton,2007-08,2008,37,413,36,394,54,492,-18,-98
Bolton,1995-96,1996,29,29,39,39,71,71,-32,-32
Bolton,2015-16,2016,0,575,0,575,0,745,0,-170
Bolton,1996-97,1997,0,29,0,39,0,71,0,-32
Bolton,2005-06,2006,56,320,49,311,41,386,8,-75
Bolton,1992-93,1993,0,0,0,0,0,0,0,0
Bolton,2017-18,2018,0,575,0,575,0,745,0,-170
Bolton,2021-22,2022,0,575,0,575,0,745,0,-170
Bolton,2012-13,2013,0,575,0,575,0,745,0,-170
Bolton,1993-94,1994,0,0,0,0,0,0,0,0
Bolton,2004-05,2005,58,264,49,262,44,345,5,-83
Bolton,2008-09,2009,41,454,41,435,53,545,-12,-110
Bolton,1994-95,1995,0,0,0,0,0,0,0,0
Bolton,1999-00,2000,0,69,0,80,0,132,0,-52
Bolton,2020-21,2021,0,575,0,575,0,745,0,-170
Bolton,2009-10,2010,39,493,42,477,67,612,-25,-135
Bolton,2000-01,2001,0,69,0,80,0,132,0,-52
Bolton,2013-14,2014,0,575,0,575,0,745,0,-170
Bolton,2001-02,2002,40,109,44,124,62,194,-18,-70
Bolton,1997-98,1998,40,69,41,80,61,132,-20,-52
Bolton,2019-20,2020,0,575,0,575,0,745,0,-170
Bolton,2006-07,2007,56,376,47,358,52,438,-5,-80
Bolton,2022-23,2023,0,575,0,575,0,745,0,-170
Bolton,2011-12,2012,36,575,46,575,77,745,-31,-170
Bolton,2018-19,2019,0,575,0,575,0,745,0,-170
Bolton,2014-15,2015,0,575,0,575,0,745,0,-170
Bolton,2016-17,2017,0,575,0,575,0,745,0,-170
Bolton,1998-99,1999,0,69,0,80,0,132,0,-52
Bolton,2023-24,2024,0,575,0,575,0,745,0,-170
Southampton,2002-03,2003,52,508,43,509,46,627,-3,-118
Southampton,2010-11,2011,0,587,0,598,0,738,0,-140
Southampton,2003-04,2004,47,555,44,553,45,672,-1,-119
Southampton,2007-08,2008,0,587,0,598,0,738,0,-140
Southampton,1995-96,1996,38,185,34,198,52,242,-18,-44
Southampton,2015-16,2016,63,807,59,814,41,918,18,-104
Southampton,1996-97,1997,41,226,50,248,56,298,-6,-50
Southampton,2005-06,2006,0,587,0,598,0,738,0,-140
Southampton,1992-93,1993,50,50,54,54,61,61,-7,-7
Southampton,2017-18,2018,36,889,37,892,56,1022,-19,-130
Southampton,2021-22,2022,40,1063,43,1078,67,1282,-24,-204
Southampton,2012-13,2013,41,628,49,647,60,798,-11,-151
Southampton,1993-94,1994,43,93,49,103,66,127,-17,-24
Southampton,2004-05,2005,32,587,45,598,66,738,-21,-140
Southampton,2008-09,2009,0,587,0,598,0,738,0,-140
Southampton,1994-95,1995,54,147,61,164,63,190,-2,-26
Southampton,1999-00,2000,44,359,45,380,62,479,-17,-99
Southampton,2020-21,2021,43,1023,47,1035,68,1215,-21,-180
Southampton,2009-10,2010,0,587,0,598,0,738,0,-140
Southampton,2000-01,2001,52,411,40,420,48,527,-8,-107
Southampton,2013-14,2014,56,684,54,701,46,844,8,-143
Southampton,2001-02,2002,45,456,46,466,54,581,-8,-115
Southampton,1997-98,1998,48,274,50,298,55,353,-5,-55
Southampton,2019-20,2020,52,980,51,988,60,1147,-9,-159
Southampton,2006-07,2007,0,587,0,598,0,738,0,-140
Southampton,2022-23,2023,25,1088,36,1114,73,1355,-37,-241
Southampton,2011-12,2012,0,587,0,598,0,738,0,-140
Southampton,2018-19,2019,39,928,45,937,65,1087,-20,-150
Southampton,2014-15,2015,60,744,54,755,33,877,21,-122
Southampton,2016-17,2017,46,853,41,855,48,966,-7,-111
Southampton,1998-99,1999,41,315,37,335,64,417,-27,-82
Southampton,2023-24,2024,0,1088,0,1114,0,1355,0,-241
Charlton Ath,2002-03,2003,49,181,45,174,56,218,-11,-44
Charlton Ath,2010-11,2011,0,361,0,342,0,442,0,-100
Charlton Ath,2003-04,2004,53,234,51,225,51,269,0,-44
Charlton Ath,2007-08,2008,0,361,0,342,0,442,0,-100
Charlton Ath,1995-96,1996,0,0,0,0,0,0,0,0
Charlton Ath,2015-16,2016,0,361,0,342,0,442,0,-100
Charlton Ath,1996-97,1997,0,0,0,0,0,0,0,0
Charlton Ath,2005-06,2006,47,327,41,308,55,382,-14,-74
Charlton Ath,1992-93,1993,0,0,0,0,0,0,0,0
Charlton Ath,2017-18,2018,0,361,0,342,0,442,0,-100
Charlton Ath,2021-22,2022,0,361,0,342,0,442,0,-100
Charlton Ath,2012-13,2013,0,361,0,342,0,442,0,-100
Charlton Ath,1993-94,1994,0,0,0,0,0,0,0,0
Charlton Ath,2004-05,2005,46,280,42,267,58,327,-16,-60
Charlton Ath,2008-09,2009,0,361,0,342,0,442,0,-100
Charlton Ath,1994-95,1995,0,0,0,0,0,0,0,0
Charlton Ath,1999-00,2000,0,36,0,41,0,56,0,-15
Charlton Ath,2020-21,2021,0,361,0,342,0,442,0,-100
Charlton Ath,2009-10,2010,0,361,0,342,0,442,0,-100
Charlton Ath,2000-01,2001,52,88,50,91,57,113,-7,-22
Charlton Ath,2013-14,2014,0,361,0,342,0,442,0,-100
Charlton Ath,2001-02,2002,44,132,38,129,49,162,-11,-33
Charlton Ath,1997-98,1998,0,0,0,0,0,0,0,0
Charlton Ath,2019-20,2020,0,361,0,342,0,442,0,-100
Charlton Ath,2006-07,2007,34,361,34,342,60,442,-26,-100
Charlton Ath,2022-23,2023,0,361,0,342,0,442,0,-100
Charlton Ath,2011-12,2012,0,361,0,342,0,442,0,-100
Charlton Ath,2018-19,2019,0,361,0,342,0,442,0,-100
Charlton Ath,2014-15,2015,0,361,0,342,0,442,0,-100
Charlton Ath,2016-17,2017,0,361,0,342,0,442,0,-100
Charlton Ath,1998-99,1999,36,36,41,41,56,56,-15,-15
Charlton Ath,2023-24,2024,0,361,0,342,0,442,0,-100
Sheffield Utd,2002-03,2003,0,94,0,96,0,113,0,-17
Sheffield Utd,2010-11,2011,0,132,0,128,0,168,0,-40
Sheffield Utd,2003-04,2004,0,94,0,96,0,113,0,-17
Sheffield Utd,2007-08,2008,0,132,0,128,0,168,0,-40
Sheffield Utd,1995-96,1996,0,94,0,96,0,113,0,-17
Sheffield Utd,2015-16,2016,0,132,0,128,0,168,0,-40
Sheffield Utd,1996-97,1997,0,94,0,96,0,113,0,-17
Sheffield Utd,2005-06,2006,0,94,0,96,0,113,0,-17
Sheffield Utd,1992-93,1993,52,52,54,54,53,53,1,1
Sheffield Utd,2017-18,2018,0,132,0,128,0,168,0,-40
Sheffield Utd,2021-22,2022,0,209,0,187,0,270,0,-83
Sheffield Utd,2012-13,2013,0,132,0,128,0,168,0,-40
Sheffield Utd,1993-94,1994,42,94,42,96,60,113,-18,-17
Sheffield Utd,2004-05,2005,0,94,0,96,0,113,0,-17
Sheffield Utd,2008-09,2009,0,132,0,128,0,168,0,-40
Sheffield Utd,1994-95,1995,0,94,0,96,0,113,0,-17
Sheffield Utd,1999-00,2000,0,94,0,96,0,113,0,-17
Sheffield Utd,2020-21,2021,23,209,20,187,63,270,-43,-83
Sheffield Utd,2009-10,2010,0,132,0,128,0,168,0,-40
Sheffield Utd,2000-01,2001,0,94,0,96,0,113,0,-17
Sheffield Utd,2013-14,2014,0,132,0,128,0,168,0,-40
Sheffield Utd,2001-02,2002,0,94,0,96,0,113,0,-17
Sheffield Utd,1997-98,1998,0,94,0,96,0,113,0,-17
Sheffield Utd,2019-20,2020,54,186,39,167,39,207,0,-40
Sheffield Utd,2006-07,2007,38,132,32,128,55,168,-23,-40
Sheffield Utd,2022-23,2023,0,209,0,187,0,270,0,-83
Sheffield Utd,2011-12,2012,0,132,0,128,0,168,0,-40
Sheffield Utd,2018-19,2019,0,132,0,128,0,168,0,-40
Sheffield Utd,2014-15,2015,0,132,0,128,0,168,0,-40
Sheffield Utd,2016-17,2017,0,132,0,128,0,168,0,-40
Sheffield Utd,1998-99,1999,0,94,0,96,0,113,0,-17
Sheffield Utd,2023-24,2024,16,225,35,222,104,374,-69,-152
Manchester City,2002-03,2003,51,274,47,268,54,341,-7,-73
Manchester City,2010-11,2011,71,695,60,678,33,707,27,-29
Manchester City,2003-04,2004,41,315,55,323,54,395,1,-72
Manchester City,2007-08,2008,55,507,45,487,53,579,-8,-92
Manchester City,1995-96,1996,38,189,33,180,58,222,-25,-42
Manchester City,2015-16,2016,66,1093,71,1093,41,886,30,207
Manchester City,1996-97,1997,0,189,0,180,0,222,0,-42
Manchester City,2005-06,2006,43,410,43,413,48,482,-5,-69
Manchester City,1992-93,1993,57,57,56,56,51,51,5,5
Manchester City,2017-18,2018,100,1271,106,1279,27,952,79,327
Manchester City,2021-22,2022,93,1629,99,1658,26,1068,73,590
Manchester City,2012-13,2013,78,862,66,837,34,770,32,67
Manchester City,1993-94,1994,45,102,38,94,49,100,-11,-6
Manchester City,2004-05,2005,52,367,47,370,39,434,8,-64
Manchester City,2008-09,2009,50,557,58,545,50,629,8,-84
Manchester City,1994-95,1995,49,151,53,147,64,164,-11,-17
Manchester City,1999-00,2000,0,189,0,180,0,222,0,-42
Manchester City,2020-21,2021,86,1536,83,1559,32,1042,51,517
Manchester City,2009-10,2010,67,624,73,618,45,674,28,-56
Manchester City,2000-01,2001,34,223,41,221,65,287,-24,-66
Manchester City,2013-14,2014,86,948,102,939,37,807,65,132
Manchester City,2001-02,2002,0,223,0,221,0,287,0,-66
Manchester City,1997-98,1998,0,189,0,180,0,222,0,-42
Manchester City,2019-20,2020,81,1450,102,1476,35,1010,67,466
Manchester City,2006-07,2007,42,452,29,442,44,526,-15,-84
Manchester City,2022-23,2023,89,1718,94,1752,33,1101,61,651
Manchester City,2011-12,2012,89,784,93,771,29,736,64,35
Manchester City,2018-19,2019,98,1369,95,1374,23,975,72,399
Manchester City,2014-15,2015,79,1027,83,1022,38,845,45,177
Manchester City,2016-17,2017,78,1171,80,1173,39,925,41,248
Manchester City,1998-99,1999,0,189,0,180,0,222,0,-42
Manchester City,2023-24,2024,91,1809,96,1848,34,1135,62,713
Sheffield Weds,2002-03,2003,0,392,0,409,0,453,0,-44
Sheffield Weds,2010-11,2011,0,392,0,409,0,453,0,-44
Sheffield Weds,2003-04,2004,0,392,0,409,0,453,0,-44
Sheffield Weds,2007-08,2008,0,392,0,409,0,453,0,-44
Sheffield Weds,1995-96,1996,40,214,48,228,61,223,-13,5
Sheffield Weds,2015-16,2016,0,392,0,409,0,453,0,-44
Sheffield Weds,1996-97,1997,57,271,50,278,51,274,-1,4
Sheffield Weds,2005-06,2006,0,392,0,409,0,453,0,-44
Sheffield Weds,1992-93,1993,59,59,55,55,51,51,4,4
Sheffield Weds,2017-18,2018,0,392,0,409,0,453,0,-44
Sheffield Weds,2021-22,2022,0,392,0,409,0,453,0,-44
Sheffield Weds,2012-13,2013,0,392,0,409,0,453,0,-44
Sheffield Weds,1993-94,1994,64,123,76,131,54,105,22,26
Sheffield Weds,2004-05,2005,0,392,0,409,0,453,0,-44
Sheffield Weds,2008-09,2009,0,392,0,409,0,453,0,-44
Sheffield Weds,1994-95,1995,51,174,49,180,57,162,-8,18
Sheffield Weds,1999-00,2000,31,392,38,409,70,453,-32,-44
Sheffield Weds,2020-21,2021,0,392,0,409,0,453,0,-44
Sheffield Weds,2009-10,2010,0,392,0,409,0,453,0,-44
Sheffield Weds,2000-01,2001,0,392,0,409,0,453,0,-44
Sheffield Weds,2013-14,2014,0,392,0,409,0,453,0,-44
Sheffield Weds,2001-02,2002,0,392,0,409,0,453,0,-44
Sheffield Weds,1997-98,1998,44,315,52,330,67,341,-15,-11
Sheffield Weds,2019-20,2020,0,392,0,409,0,453,0,-44
Sheffield Weds,2006-07,2007,0,392,0,409,0,453,0,-44
Sheffield Weds,2022-23,2023,0,392,0,409,0,453,0,-44
Sheffield Weds,2011-12,2012,0,392,0,409,0,453,0,-44
Sheffield Weds,2018-19,2019,0,392,0,409,0,453,0,-44
Sheffield Weds,2014-15,2015,0,392,0,409,0,453,0,-44
Sheffield Weds,2016-17,2017,0,392,0,409,0,453,0,-44
Sheffield Weds,1998-99,1999,46,361,41,371,42,383,-1,-12
Sheffield Weds,2023-24,2024,0,392,0,409,0,453,0,-44
Newcastle Utd,2002-03,2003,69,628,63,615,48,467,15,148
Newcastle Utd,2010-11,2011,46,952,56,940,57,834,-1,106
Newcastle Utd,2003-04,2004,56,684,52,667,40,507,12,160
Newcastle Utd,2007-08,2008,43,872,45,844,65,718,-20,126
Newcastle Utd,1995-96,1996,78,227,66,215,37,125,29,90
Newcastle Utd,2015-16,2016,37,1183,44,1168,65,1140,-21,28
Newcastle Utd,1996-97,1997,68,295,73,288,40,165,33,123
Newcastle Utd,2005-06,2006,58,786,47,761,42,606,5,155
Newcastle Utd,1992-93,1993,0,0,0,0,0,0,0,0
Newcastle Utd,2017-18,2018,44,1227,39,1207,47,1187,-8,20
Newcastle Utd,2021-22,2022,49,1410,44,1377,62,1417,-18,-40
Newcastle Utd,2012-13,2013,41,1058,45,1041,68,953,-23,88
Newcastle Utd,1993-94,1994,77,77,82,82,41,41,41,41
Newcastle Utd,2004-05,2005,44,728,47,714,57,564,-10,150
Newcastle Utd,2008-09,2009,34,906,40,884,59,777,-19,107
Newcastle Utd,1994-95,1995,72,149,67,149,47,88,20,61
Newcastle Utd,1999-00,2000,52,437,63,434,54,317,9,117
Newcastle Utd,2020-21,2021,45,1361,46,1333,62,1355,-16,-22
Newcastle Utd,2009-10,2010,0,906,0,884,0,777,0,107
Newcastle Utd,2000-01,2001,51,488,44,478,50,367,-6,111
Newcastle Utd,2013-14,2014,49,1107,43,1084,59,1012,-16,72
Newcastle Utd,2001-02,2002,71,559,74,552,52,419,22,133
Newcastle Utd,1997-98,1998,44,339,35,323,44,209,-9,114
Newcastle Utd,2019-20,2020,44,1316,38,1287,58,1293,-20,-6
Newcastle Utd,2006-07,2007,43,829,38,799,47,653,-9,146
Newcastle Utd,2022-23,2023,71,1481,68,1445,33,1450,35,-5
Newcastle Utd,2011-12,2012,65,1017,56,996,51,885,5,111
Newcastle Utd,2018-19,2019,45,1272,42,1249,48,1235,-6,14
Newcastle Utd,2014-15,2015,39,1146,40,1124,63,1075,-23,49
Newcastle Utd,2016-17,2017,0,1183,0,1168,0,1140,0,28
Newcastle Utd,1998-99,1999,46,385,48,371,54,263,-6,108
Newcastle Utd,2023-24,2024,60,1541,85,1530,62,1512,23,18
West Ham,2002-03,2003,42,500,42,462,59,535,-17,-73
West Ham,2010-11,2011,33,764,43,723,70,880,-27,-157
West Ham,2003-04,2004,0,500,0,462,0,535,0,-73
West Ham,2007-08,2008,49,645,42,591,50,699,-8,-108
West Ham,1995-96,1996,51,153,43,134,52,158,-9,-24
West Ham,2015-16,2016,62,959,65,917,51,1082,14,-165
West Ham,1996-97,1997,42,195,39,173,48,206,-9,-33
West Ham,2005-06,2006,55,555,52,514,55,590,-3,-76
West Ham,1992-93,1993,0,0,0,0,0,0,0,0
West Ham,2017-18,2018,42,1046,48,1012,68,1214,-20,-202
West Ham,2021-22,2022,56,1258,60,1235,51,1429,9,-194
West Ham,2012-13,2013,46,810,45,768,53,933,-8,-165
West Ham,1993-94,1994,52,52,47,47,58,58,-11,-11
West Ham,2004-05,2005,0,500,0,462,0,535,0,-73
West Ham,2008-09,2009,51,696,42,633,45,744,-3,-111
West Ham,1994-95,1995,50,102,44,91,48,106,-4,-15
West Ham,1999-00,2000,55,363,52,327,53,369,-1,-42
West Ham,2020-21,2021,65,1202,62,1175,47,1378,15,-203
West Ham,2009-10,2010,35,731,47,680,66,810,-19,-130
West Ham,2000-01,2001,42,405,45,372,50,419,-5,-47
West Ham,2013-14,2014,40,850,40,808,51,984,-11,-176
West Ham,2001-02,2002,53,458,48,420,57,476,-9,-56
West Ham,1997-98,1998,56,251,56,229,57,263,-1,-34
West Ham,2019-20,2020,39,1137,49,1113,62,1331,-13,-218
West Ham,2006-07,2007,41,596,35,549,59,649,-24,-100
West Ham,2022-23,2023,40,1298,42,1277,55,1484,-13,-207
West Ham,2011-12,2012,0,764,0,723,0,880,0,-157
West Ham,2018-19,2019,52,1098,52,1064,55,1269,-3,-205
West Ham,2014-15,2015,47,897,44,852,47,1031,-3,-179
West Ham,2016-17,2017,45,1004,47,964,64,1146,-17,-182
West Ham,1998-99,1999,57,308,46,275,53,316,-7,-41
West Ham,2023-24,2024,52,1350,60,1337,74,1558,-14,-221
Middlesbrough,2002-03,2003,49,371,48,361,44,426,4,-65
Middlesbrough,2010-11,2011,0,639,0,621,0,741,0,-120
Middlesbrough,2003-04,2004,48,419,44,405,52,478,-8,-73
Middlesbrough,2007-08,2008,42,607,43,593,53,684,-10,-91
Middlesbrough,1995-96,1996,43,87,35,89,50,125,-15,-36
Middlesbrough,2015-16,2016,0,639,0,621,0,741,0,-120
Middlesbrough,1996-97,1997,45,132,51,140,60,185,-9,-45
Middlesbrough,2005-06,2006,45,519,48,506,58,582,-10,-76
Middlesbrough,1992-93,1993,44,44,54,54,75,75,-21,-21
Middlesbrough,2017-18,2018,0,667,0,648,0,794,0,-146
Middlesbrough,2021-22,2022,0,667,0,648,0,794,0,-146
Middlesbrough,2012-13,2013,0,639,0,621,0,741,0,-120
Middlesbrough,1993-94,1994,0,44,0,54,0,75,0,-21
Middlesbrough,2004-05,2005,55,474,53,458,46,524,7,-66
Middlesbrough,2008-09,2009,32,639,28,621,57,741,-29,-120
Middlesbrough,1994-95,1995,0,44,0,54,0,75,0,-21
Middlesbrough,1999-00,2000,52,235,46,234,52,291,-6,-57
Middlesbrough,2020-21,2021,0,667,0,648,0,794,0,-146
Middlesbrough,2009-10,2010,0,639,0,621,0,741,0,-120
Middlesbrough,2000-01,2001,42,277,44,278,44,335,0,-57
Middlesbrough,2013-14,2014,0,639,0,621,0,741,0,-120
Middlesbrough,2001-02,2002,45,322,35,313,47,382,-12,-69
Middlesbrough,1997-98,1998,0,132,0,140,0,185,0,-45
Middlesbrough,2019-20,2020,0,667,0,648,0,794,0,-146
Middlesbrough,2006-07,2007,46,565,44,550,49,631,-5,-81
Middlesbrough,2022-23,2023,0,667,0,648,0,794,0,-146
Middlesbrough,2011-12,2012,0,639,0,621,0,741,0,-120
Middlesbrough,2018-19,2019,0,667,0,648,0,794,0,-146
Middlesbrough,2014-15,2015,0,639,0,621,0,741,0,-120
Middlesbrough,2016-17,2017,28,667,27,648,53,794,-26,-146
Middlesbrough,1998-99,1999,51,183,48,188,54,239,-6,-51
Middlesbrough,2023-24,2024,0,667,0,648,0,794,0,-146
Coventry City,2002-03,2003,0,409,0,387,0,490,0,-103
Coventry City,2010-11,2011,0,409,0,387,0,490,0,-103
Coventry City,2003-04,2004,0,409,0,387,0,490,0,-103
Coventry City,2007-08,2008,0,409,0,387,0,490,0,-103
Coventry City,1995-96,1996,38,196,42,181,60,224,-18,-43
Coventry City,2015-16,2016,0,409,0,387,0,490,0,-103
Coventry City,1996-97,1997,41,237,38,219,54,278,-16,-59
Coventry City,2005-06,2006,0,409,0,387,0,490,0,-103
Coventry City,1992-93,1993,52,52,52,52,57,57,-5,-5
Coventry City,2017-18,2018,0,409,0,387,0,490,0,-103
Coventry City,2021-22,2022,0,409,0,387,0,490,0,-103
Coventry City,2012-13,2013,0,409,0,387,0,490,0,-103
Coventry City,1993-94,1994,56,108,43,95,45,102,-2,-7
Coventry City,2004-05,2005,0,409,0,387,0,490,0,-103
Coventry City,2008-09,2009,0,409,0,387,0,490,0,-103
Coventry City,1994-95,1995,50,158,44,139,62,164,-18,-25
Coventry City,1999-00,2000,44,375,47,351,54,427,-7,-76
Coventry City,2020-21,2021,0,409,0,387,0,490,0,-103
Coventry City,2009-10,2010,0,409,0,387,0,490,0,-103
Coventry City,2000-01,2001,34,409,36,387,63,490,-27,-103
Coventry City,2013-14,2014,0,409,0,387,0,490,0,-103
Coventry City,2001-02,2002,0,409,0,387,0,490,0,-103
Coventry City,1997-98,1998,52,289,46,265,44,322,2,-57
Coventry City,2019-20,2020,0,409,0,387,0,490,0,-103
Coventry City,2006-07,2007,0,409,0,387,0,490,0,-103
Coventry City,2022-23,2023,0,409,0,387,0,490,0,-103
Coventry City,2011-12,2012,0,409,0,387,0,490,0,-103
Coventry City,2018-19,2019,0,409,0,387,0,490,0,-103
Coventry City,2014-15,2015,0,409,0,387,0,490,0,-103
Coventry City,2016-17,2017,0,409,0,387,0,490,0,-103
Coventry City,1998-99,1999,42,331,39,304,51,373,-12,-69
Coventry City,2023-24,2024,0,409,0,387,0,490,0,-103
Luton Town,2002-03,2003,0,0,0,0,0,0,0,0
Luton Town,2010-11,2011,0,0,0,0,0,0,0,0
Luton Town,2003-04,2004,0,0,0,0,0,0,0,0
Luton Town,2007-08,2008,0,0,0,0,0,0,0,0
Luton Town,1995-96,1996,0,0,0,0,0,0,0,0
Luton Town,2015-16,2016,0,0,0,0,0,0,0,0
Luton Town,1996-97,1997,0,0,0,0,0,0,0,0
Luton Town,2005-06,2006,0,0,0,0,0,0,0,0
Luton Town,1992-93,1993,0,0,0,0,0,0,0,0
Luton Town,2017-18,2018,0,0,0,0,0,0,0,0
Luton Town,2021-22,2022,0,0,0,0,0,0,0,0
Luton Town,2012-13,2013,0,0,0,0,0,0,0,0
Luton Town,1993-94,1994,0,0,0,0,0,0,0,0
Luton Town,2004-05,2005,0,0,0,0,0,0,0,0
Luton Town,2008-09,2009,0,0,0,0,0,0,0,0
Luton Town,1994-95,1995,0,0,0,0,0,0,0,0
Luton Town,1999-00,2000,0,0,0,0,0,0,0,0
Luton Town,2020-21,2021,0,0,0,0,0,0,0,0
Luton Town,2009-10,2010,0,0,0,0,0,0,0,0
Luton Town,2000-01,2001,0,0,0,0,0,0,0,0
Luton Town,2013-14,2014,0,0,0,0,0,0,0,0
Luton Town,2001-02,2002,0,0,0,0,0,0,0,0
Luton Town,1997-98,1998,0,0,0,0,0,0,0,0
Luton Town,2019-20,2020,0,0,0,0,0,0,0,0
Luton Town,2006-07,2007,0,0,0,0,0,0,0,0
Luton Town,2022-23,2023,0,0,0,0,0,0,0,0
Luton Town,2011-12,2012,0,0,0,0,0,0,0,0
Luton Town,2018-19,2019,0,0,0,0,0,0,0,0
Luton Town,2014-15,2015,0,0,0,0,0,0,0,0
Luton Town,2016-17,2017,0,0,0,0,0,0,0,0
Luton Town,1998-99,1999,0,0,0,0,0,0,0,0
Luton Town,2023-24,2024,26,26,52,52,85,85,-33,-33
Derby County,2002-03,2003,0,263,0,251,0,331,0,-80
Derby County,2010-11,2011,0,274,0,271,0,420,0,-149
Derby County,2003-04,2004,0,263,0,251,0,331,0,-80
Derby County,2007-08,2008,11,274,20,271,89,420,-69,-149
Derby County,1995-96,1996,0,0,0,0,0,0,0,0
Derby County,2015-16,2016,0,274,0,271,0,420,0,-149
Derby County,1996-97,1997,46,46,45,45,58,58,-13,-13
Derby County,2005-06,2006,0,263,0,251,0,331,0,-80
Derby County,1992-93,1993,0,0,0,0,0,0,0,0
Derby County,2017-18,2018,0,274,0,271,0,420,0,-149
Derby County,2021-22,2022,0,274,0,271,0,420,0,-149
Derby County,2012-13,2013,0,274,0,271,0,420,0,-149
Derby County,1993-94,1994,0,0,0,0,0,0,0,0
Derby County,2004-05,2005,0,263,0,251,0,331,0,-80
Derby County,2008-09,2009,0,274,0,271,0,420,0,-149
Derby County,1994-95,1995,0,0,0,0,0,0,0,0
Derby County,1999-00,2000,38,191,44,181,57,209,-13,-28
Derby County,2020-21,2021,0,274,0,271,0,420,0,-149
Derby County,2009-10,2010,0,274,0,271,0,420,0,-149
Derby County,2000-01,2001,42,233,37,218,59,268,-22,-50
Derby County,2013-14,2014,0,274,0,271,0,420,0,-149
Derby County,2001-02,2002,30,263,33,251,63,331,-30,-80
Derby County,1997-98,1998,55,101,52,97,49,107,3,-10
Derby County,2019-20,2020,0,274,0,271,0,420,0,-149
Derby County,2006-07,2007,0,263,0,251,0,331,0,-80
Derby County,2022-23,2023,0,274,0,271,0,420,0,-149
Derby County,2011-12,2012,0,274,0,271,0,420,0,-149
Derby County,2018-19,2019,0,274,0,271,0,420,0,-149
Derby County,2014-15,2015,0,274,0,271,0,420,0,-149
Derby County,2016-17,2017,0,274,0,271,0,420,0,-149
Derby County,1998-99,1999,52,153,40,137,45,152,-5,-15
Derby County,2023-24,2024,0,274,0,271,0,420,0,-149
Portsmouth,2002-03,2003,0,0,0,0,0,0,0,0
Portsmouth,2010-11,2011,0,311,0,292,0,380,0,-88
Portsmouth,2003-04,2004,45,45,47,47,54,54,-7,-7
Portsmouth,2007-08,2008,57,233,48,220,40,257,8,-37
Portsmouth,1995-96,1996,0,0,0,0,0,0,0,0
Portsmouth,2015-16,2016,0,311,0,292,0,380,0,-88
Portsmouth,1996-97,1997,0,0,0,0,0,0,0,0
Portsmouth,2005-06,2006,38,122,37,127,62,175,-25,-48
Portsmouth,1992-93,1993,0,0,0,0,0,0,0,0
Portsmouth,2017-18,2018,0,311,0,292,0,380,0,-88
Portsmouth,2021-22,2022,0,311,0,292,0,380,0,-88
Portsmouth,2012-13,2013,0,311,0,292,0,380,0,-88
Portsmouth,1993-94,1994,0,0,0,0,0,0,0,0
Portsmouth,2004-05,2005,39,84,43,90,59,113,-16,-23
Portsmouth,2008-09,2009,41,274,38,258,57,314,-19,-56
Portsmouth,1994-95,1995,0,0,0,0,0,0,0,0
Portsmouth,1999-00,2000,0,0,0,0,0,0,0,0
Portsmouth,2020-21,2021,0,311,0,292,0,380,0,-88
Portsmouth,2009-10,2010,37,311,34,292,66,380,-32,-88
Portsmouth,2000-01,2001,0,0,0,0,0,0,0,0
Portsmouth,2013-14,2014,0,311,0,292,0,380,0,-88
Portsmouth,2001-02,2002,0,0,0,0,0,0,0,0
Portsmouth,1997-98,1998,0,0,0,0,0,0,0,0
Portsmouth,2019-20,2020,0,311,0,292,0,380,0,-88
Portsmouth,2006-07,2007,54,176,45,172,42,217,3,-45
Portsmouth,2022-23,2023,0,311,0,292,0,380,0,-88
Portsmouth,2011-12,2012,0,311,0,292,0,380,0,-88
Portsmouth,2018-19,2019,0,311,0,292,0,380,0,-88
Portsmouth,2014-15,2015,0,311,0,292,0,380,0,-88
Portsmouth,2016-17,2017,0,311,0,292,0,380,0,-88
Portsmouth,1998-99,1999,0,0,0,0,0,0,0,0
Portsmouth,2023-24,2024,0,311,0,292,0,380,0,-88
Chelsea,2002-03,2003,67,665,68,637,38,489,30,148
Chelsea,2010-11,2011,71,1338,69,1217,33,695,36,522
Chelsea,2003-04,2004,79,744,67,704,30,519,37,185
Chelsea,2007-08,2008,85,1098,65,977,26,606,39,371
Chelsea,1995-96,1996,50,211,46,196,44,206,2,-10
Chelsea,2015-16,2016,50,1696,59,1560,53,892,6,668
Chelsea,1996-97,1997,59,270,58,254,55,261,3,-7
Chelsea,2005-06,2006,91,930,72,848,22,556,50,292
Chelsea,1992-93,1993,56,56,51,51,54,54,-3,-3
Chelsea,2017-18,2018,70,1859,62,1707,38,963,24,744
Chelsea,2021-22,2022,74,2138,76,1973,33,1125,43,848
Chelsea,2012-13,2013,75,1477,75,1357,39,780,36,577
Chelsea,1993-94,1994,51,107,49,100,53,107,-4,-7
Chelsea,2004-05,2005,95,839,72,776,15,534,57,242
Chelsea,2008-09,2009,83,1181,68,1045,24,630,44,415
Chelsea,1994-95,1995,54,161,50,150,55,162,-5,-12
Chelsea,1999-00,2000,65,473,53,435,34,368,19,67
Chelsea,2020-21,2021,67,2064,58,1897,36,1092,22,805
Chelsea,2009-10,2010,86,1267,103,1148,32,662,71,486
Chelsea,2000-01,2001,61,534,68,503,45,413,23,90
Chelsea,2013-14,2014,82,1559,71,1428,27,807,44,621
Chelsea,2001-02,2002,64,598,66,569,38,451,28,118
Chelsea,1997-98,1998,63,333,71,325,43,304,28,21
Chelsea,2019-20,2020,66,1997,69,1839,54,1056,15,783
Chelsea,2006-07,2007,83,1013,64,912,24,580,40,332
Chelsea,2022-23,2023,44,2182,38,2011,47,1172,-9,839
Chelsea,2011-12,2012,64,1402,65,1282,46,741,19,541
Chelsea,2018-19,2019,72,1931,63,1770,39,1002,24,768
Chelsea,2014-15,2015,87,1646,73,1501,32,839,41,662
Chelsea,2016-17,2017,93,1789,85,1645,33,925,52,720
Chelsea,1998-99,1999,75,408,57,382,30,334,27,48
Chelsea,2023-24,2024,63,2245,77,2088,63,1235,14,853
Arsenal,2002-03,2003,78,773,85,683,42,388,43,295
Arsenal,2010-11,2011,68,1379,72,1271,43,668,29,603
Arsenal,2003-04,2004,90,863,73,756,26,414,47,342
Arsenal,2007-08,2008,83,1164,74,1048,31,547,43,501
Arsenal,1995-96,1996,63,241,49,194,32,147,17,47
Arsenal,2015-16,2016,71,1747,65,1621,36,867,29,754
Arsenal,1996-97,1997,68,309,62,256,32,179,30,77
Arsenal,2005-06,2006,67,1013,68,911,31,481,37,430
Arsenal,1992-93,1993,56,56,40,40,38,38,2,2
Arsenal,2017-18,2018,63,1885,74,1772,51,962,23,810
Arsenal,2021-22,2022,69,2141,61,2017,48,1148,13,869
Arsenal,2012-13,2013,73,1522,72,1417,37,754,35,663
Arsenal,1993-94,1994,71,127,53,93,28,66,25,27
Arsenal,2004-05,2005,83,946,87,843,36,450,51,393
Arsenal,2008-09,2009,72,1236,68,1116,37,584,31,532
Arsenal,1994-95,1995,51,178,52,145,49,115,3,30
Arsenal,1999-00,2000,73,538,73,456,43,272,30,184
Arsenal,2020-21,2021,61,2072,55,1956,39,1100,16,856
Arsenal,2009-10,2010,75,1311,83,1199,41,625,42,574
Arsenal,2000-01,2001,70,608,63,519,38,310,25,209
Arsenal,2013-14,2014,79,1601,68,1485,41,795,27,690
Arsenal,2001-02,2002,87,695,79,598,36,346,43,252
Arsenal,1997-98,1998,78,387,68,324,33,212,35,112
Arsenal,2019-20,2020,56,2011,56,1901,48,1061,8,840
Arsenal,2006-07,2007,68,1081,63,974,35,516,28,458
Arsenal,2022-23,2023,84,2225,88,2105,43,1191,45,914
Arsenal,2011-12,2012,70,1449,74,1345,49,717,25,628
Arsenal,2018-19,2019,70,1955,73,1845,51,1013,22,832
Arsenal,2014-15,2015,75,1676,71,1556,36,831,35,725
Arsenal,2016-17,2017,75,1822,77,1698,44,911,33,787
Arsenal,1998-99,1999,78,465,59,383,17,229,42,154
Arsenal,2023-24,2024,89,2314,91,2196,29,1220,62,976
Brighton,2002-03,2003,0,0,0,0,0,0,0,0
Brighton,2010-11,2011,0,0,0,0,0,0,0,0
Brighton,2003-04,2004,0,0,0,0,0,0,0,0
Brighton,2007-08,2008,0,0,0,0,0,0,0,0
Brighton,1995-96,1996,0,0,0,0,0,0,0,0
Brighton,2015-16,2016,0,0,0,0,0,0,0,0
Brighton,1996-97,1997,0,0,0,0,0,0,0,0
Brighton,2005-06,2006,0,0,0,0,0,0,0,0
Brighton,1992-93,1993,0,0,0,0,0,0,0,0
Brighton,2017-18,2018,40,40,34,34,54,54,-20,-20
Brighton,2021-22,2022,51,209,42,190,44,258,-2,-68
Brighton,2012-13,2013,0,0,0,0,0,0,0,0
Brighton,1993-94,1994,0,0,0,0,0,0,0,0
Brighton,2004-05,2005,0,0,0,0,0,0,0,0
Brighton,2008-09,2009,0,0,0,0,0,0,0,0
Brighton,1994-95,1995,0,0,0,0,0,0,0,0
Brighton,1999-00,2000,0,0,0,0,0,0,0,0
Brighton,2020-21,2021,41,158,40,148,46,214,-6,-66
Brighton,2009-10,2010,0,0,0,0,0,0,0,0
Brighton,2000-01,2001,0,0,0,0,0,0,0,0
Brighton,2013-14,2014,0,0,0,0,0,0,0,0
Brighton,2001-02,2002,0,0,0,0,0,0,0,0
Brighton,1997-98,1998,0,0,0,0,0,0,0,0
Brighton,2019-20,2020,41,117,39,108,54,168,-15,-60
Brighton,2006-07,2007,0,0,0,0,0,0,0,0
Brighton,2022-23,2023,62,271,72,262,53,311,19,-49
Brighton,2011-12,2012,0,0,0,0,0,0,0,0
Brighton,2018-19,2019,36,76,35,69,60,114,-25,-45
Brighton,2014-15,2015,0,0,0,0,0,0,0,0
Brighton,2016-17,2017,0,0,0,0,0,0,0,0
Brighton,1998-99,1999,0,0,0,0,0,0,0,0
Brighton,2023-24,2024,48,319,55,317,62,373,-7,-56
Reading,2002-03,2003,0,0,0,0,0,0,0,0
Reading,2010-11,2011,0,91,0,93,0,113,0,-20
Reading,2003-04,2004,0,0,0,0,0,0,0,0
Reading,2007-08,2008,36,91,41,93,66,113,-25,-20
Reading,1995-96,1996,0,0,0,0,0,0,0,0
Reading,2015-16,2016,0,119,0,136,0,186,0,-50
Reading,1996-97,1997,0,0,0,0,0,0,0,0
Reading,2005-06,2006,0,0,0,0,0,0,0,0
Reading,1992-93,1993,0,0,0,0,0,0,0,0
Reading,2017-18,2018,0,119,0,136,0,186,0,-50
Reading,2021-22,2022,0,119,0,136,0,186,0,-50
Reading,2012-13,2013,28,119,43,136,73,186,-30,-50
Reading,1993-94,1994,0,0,0,0,0,0,0,0
Reading,2004-05,2005,0,0,0,0,0,0,0,0
Reading,2008-09,2009,0,91,0,93,0,113,0,-20
Reading,1994-95,1995,0,0,0,0,0,0,0,0
Reading,1999-00,2000,0,0,0,0,0,0,0,0
Reading,2020-21,2021,0,119,0,136,0,186,0,-50
Reading,2009-10,2010,0,91,0,93,0,113,0,-20
Reading,2000-01,2001,0,0,0,0,0,0,0,0
Reading,2013-14,2014,0,119,0,136,0,186,0,-50
Reading,2001-02,2002,0,0,0,0,0,0,0,0
Reading,1997-98,1998,0,0,0,0,0,0,0,0
Reading,2019-20,2020,0,119,0,136,0,186,0,-50
Reading,2006-07,2007,55,55,52,52,47,47,5,5
Reading,2022-23,2023,0,119,0,136,0,186,0,-50
Reading,2011-12,2012,0,91,0,93,0,113,0,-20
Reading,2018-19,2019,0,119,0,136,0,186,0,-50
Reading,2014-15,2015,0,119,0,136,0,186,0,-50
Reading,2016-17,2017,0,119,0,136,0,186,0,-50
Reading,1998-99,1999,0,0,0,0,0,0,0,0
Reading,2023-24,2024,0,119,0,136,0,186,0,-50
Leeds United,2002-03,2003,47,659,58,601,57,494,1,107
Leeds United,2010-11,2011,0,692,0,641,0,573,0,68
Leeds United,2003-04,2004,33,692,40,641,79,573,-39,68
Leeds United,2007-08,2008,0,692,0,641,0,573,0,68
Leeds United,1995-96,1996,43,237,40,221,57,196,-17,25
Leeds United,2015-16,2016,0,692,0,641,0,573,0,68
Leeds United,1996-97,1997,46,283,28,249,38,234,-10,15
Leeds United,2005-06,2006,0,692,0,641,0,573,0,68
Leeds United,1992-93,1993,51,51,57,57,62,62,-5,-5
Leeds United,2017-18,2018,0,692,0,641,0,573,0,68
Leeds United,2021-22,2022,38,789,42,745,79,706,-37,39
Leeds United,2012-13,2013,0,692,0,641,0,573,0,68
Leeds United,1993-94,1994,70,121,65,122,39,101,26,21
Leeds United,2004-05,2005,0,692,0,641,0,573,0,68
Leeds United,2008-09,2009,0,692,0,641,0,573,0,68
Leeds United,1994-95,1995,73,194,59,181,38,139,21,42
Leeds United,1999-00,2000,69,478,58,426,43,357,15,69
Leeds United,2020-21,2021,59,751,62,703,54,627,8,76
Leeds United,2009-10,2010,0,692,0,641,0,573,0,68
Leeds United,2000-01,2001,68,546,64,490,43,400,21,90
Leeds United,2013-14,2014,0,692,0,641,0,573,0,68
Leeds United,2001-02,2002,66,612,53,543,37,437,16,106
Leeds United,1997-98,1998,59,342,57,306,46,280,11,26
Leeds United,2019-20,2020,0,692,0,641,0,573,0,68
Leeds United,2006-07,2007,0,692,0,641,0,573,0,68
Leeds United,2022-23,2023,31,820,48,793,78,784,-30,9
Leeds United,2011-12,2012,0,692,0,641,0,573,0,68
Leeds United,2018-19,2019,0,692,0,641,0,573,0,68
Leeds United,2014-15,2015,0,692,0,641,0,573,0,68
Leeds United,2016-17,2017,0,692,0,641,0,573,0,68
Leeds United,1998-99,1999,67,409,62,368,34,314,28,54
Leeds United,2023-24,2024,0,820,0,793,0,784,0,9
Manchester Utd,2002-03,2003,83,908,74,863,34,394,40,469
Manchester Utd,2010-11,2011,80,1574,78,1452,37,627,41,825
Manchester Utd,2003-04,2004,75,983,64,927,35,429,29,498
Manchester Utd,2007-08,2008,87,1319,80,1220,22,538,58,682
Manchester Utd,1995-96,1996,82,346,73,297,35,132,38,165
Manchester Utd,2015-16,2016,66,1952,49,1802,35,818,14,984
Manchester Utd,1996-97,1997,75,421,76,373,44,176,32,197
Manchester Utd,2005-06,2006,83,1143,72,1057,34,489,38,568
Manchester Utd,1992-93,1993,84,84,67,67,31,31,36,36
Manchester Utd,2017-18,2018,81,2102,68,1924,28,875,40,1049
Manchester Utd,2021-22,2022,58,2366,57,2185,57,1066,0,1119
Manchester Utd,2012-13,2013,89,1752,86,1627,43,703,43,924
Manchester Utd,1993-94,1994,92,176,80,147,38,69,42,78
Manchester Utd,2004-05,2005,77,1060,58,985,26,455,32,530
Manchester Utd,2008-09,2009,90,1409,68,1288,24,562,44,726
Manchester Utd,1994-95,1995,88,264,77,224,28,97,49,127
Manchester Utd,1999-00,2000,91,668,97,623,45,284,52,339
Manchester Utd,2020-21,2021,74,2308,73,2128,44,1009,29,1119
Manchester Utd,2009-10,2010,85,1494,86,1374,28,590,58,784
Manchester Utd,2000-01,2001,80,748,79,702,31,315,48,387
Manchester Utd,2013-14,2014,64,1816,64,1691,43,746,21,945
Manchester Utd,2001-02,2002,77,825,87,789,45,360,42,429
Manchester Utd,1997-98,1998,77,498,73,446,26,202,47,244
Manchester Utd,2019-20,2020,66,2234,66,2055,36,965,30,1090
Manchester Utd,2006-07,2007,89,1232,83,1140,27,516,56,624
Manchester Utd,2022-23,2023,75,2441,58,2243,43,1109,15,1134
Manchester Utd,2011-12,2012,89,1663,89,1541,33,660,56,881
Manchester Utd,2018-19,2019,66,2168,65,1989,54,929,11,1060
Manchester Utd,2014-15,2015,70,1886,62,1753,37,783,25,970
Manchester Utd,2016-17,2017,69,2021,54,1856,29,847,25,1009
Manchester Utd,1998-99,1999,79,577,80,526,37,239,43,287
Manchester Utd,2023-24,2024,60,2501,57,2300,58,1167,-1,1133
Watford,2002-03,2003,0,24,0,35,0,77,0,-42
Watford,2010-11,2011,0,52,0,64,0,136,0,-72
Watford,2003-04,2004,0,24,0,35,0,77,0,-42
Watford,2007-08,2008,0,52,0,64,0,136,0,-72
Watford,1995-96,1996,0,0,0,0,0,0,0,0
Watford,2015-16,2016,45,97,40,104,50,186,-10,-82
Watford,1996-97,1997,0,0,0,0,0,0,0,0
Watford,2005-06,2006,0,24,0,35,0,77,0,-42
Watford,1992-93,1993,0,0,0,0,0,0,0,0
Watford,2017-18,2018,41,178,44,188,64,318,-20,-130
Watford,2021-22,2022,23,285,34,310,77,518,-43,-208
Watford,2012-13,2013,0,52,0,64,0,136,0,-72
Watford,1993-94,1994,0,0,0,0,0,0,0,0
Watford,2004-05,2005,0,24,0,35,0,77,0,-42
Watford,2008-09,2009,0,52,0,64,0,136,0,-72
Watford,1994-95,1995,0,0,0,0,0,0,0,0
Watford,1999-00,2000,24,24,35,35,77,77,-42,-42
Watford,2020-21,2021,0,262,0,276,0,441,0,-165
Watford,2009-10,2010,0,52,0,64,0,136,0,-72
Watford,2000-01,2001,0,24,0,35,0,77,0,-42
Watford,2013-14,2014,0,52,0,64,0,136,0,-72
Watford,2001-02,2002,0,24,0,35,0,77,0,-42
Watford,1997-98,1998,0,0,0,0,0,0,0,0
Watford,2019-20,2020,34,262,36,276,64,441,-28,-165
Watford,2006-07,2007,28,52,29,64,59,136,-30,-72
Watford,2022-23,2023,0,285,0,310,0,518,0,-208
Watford,2011-12,2012,0,52,0,64,0,136,0,-72
Watford,2018-19,2019,50,228,52,240,59,377,-7,-137
Watford,2014-15,2015,0,52,0,64,0,136,0,-72
Watford,2016-17,2017,40,137,40,144,68,254,-28,-110
Watford,1998-99,1999,0,0,0,0,0,0,0,0
Watford,2023-24,2024,0,285,0,310,0,518,0,-208
Wigan Athletic,2002-03,2003,0,0,0,0,0,0,0,0
Wigan Athletic,2010-11,2011,42,252,40,227,61,347,-21,-120
Wigan Athletic,2003-04,2004,0,0,0,0,0,0,0,0
Wigan Athletic,2007-08,2008,40,129,34,116,51,162,-17,-46
Wigan Athletic,1995-96,1996,0,0,0,0,0,0,0,0
Wigan Athletic,2015-16,2016,0,331,0,316,0,482,0,-166
Wigan Athletic,1996-97,1997,0,0,0,0,0,0,0,0
Wigan Athletic,2005-06,2006,51,51,45,45,52,52,-7,-7
Wigan Athletic,1992-93,1993,0,0,0,0,0,0,0,0
Wigan Athletic,2017-18,2018,0,331,0,316,0,482,0,-166
Wigan Athletic,2021-22,2022,0,331,0,316,0,482,0,-166
Wigan Athletic,2012-13,2013,36,331,47,316,73,482,-26,-166
Wigan Athletic,1993-94,1994,0,0,0,0,0,0,0,0
Wigan Athletic,2004-05,2005,0,0,0,0,0,0,0,0
Wigan Athletic,2008-09,2009,45,174,34,150,45,207,-11,-57
Wigan Athletic,1994-95,1995,0,0,0,0,0,0,0,0
Wigan Athletic,1999-00,2000,0,0,0,0,0,0,0,0
Wigan Athletic,2020-21,2021,0,331,0,316,0,482,0,-166
Wigan Athletic,2009-10,2010,36,210,37,187,79,286,-42,-99
Wigan Athletic,2000-01,2001,0,0,0,0,0,0,0,0
Wigan Athletic,2013-14,2014,0,331,0,316,0,482,0,-166
Wigan Athletic,2001-02,2002,0,0,0,0,0,0,0,0
Wigan Athletic,1997-98,1998,0,0,0,0,0,0,0,0
Wigan Athletic,2019-20,2020,0,331,0,316,0,482,0,-166
Wigan Athletic,2006-07,2007,38,89,37,82,59,111,-22,-29
Wigan Athletic,2022-23,2023,0,331,0,316,0,482,0,-166
Wigan Athletic,2011-12,2012,43,295,42,269,62,409,-20,-140
Wigan Athletic,2018-19,2019,0,331,0,316,0,482,0,-166
Wigan Athletic,2014-15,2015,0,331,0,316,0,482,0,-166
Wigan Athletic,2016-17,2017,0,331,0,316,0,482,0,-166
Wigan Athletic,1998-99,1999,0,0,0,0,0,0,0,0
Wigan Athletic,2023-24,2024,0,331,0,316,0,482,0,-166
Hull City,2002-03,2003,0,0,0,0,0,0,0,0
Hull City,2010-11,2011,0,65,0,73,0,139,0,-66
Hull City,2003-04,2004,0,0,0,0,0,0,0,0
Hull City,2007-08,2008,0,0,0,0,0,0,0,0
Hull City,1995-96,1996,0,0,0,0,0,0,0,0
Hull City,2015-16,2016,0,137,0,144,0,243,0,-99
Hull City,1996-97,1997,0,0,0,0,0,0,0,0
Hull City,2005-06,2006,0,0,0,0,0,0,0,0
Hull City,1992-93,1993,0,0,0,0,0,0,0,0
Hull City,2017-18,2018,0,171,0,181,0,323,0,-142
Hull City,2021-22,2022,0,171,0,181,0,323,0,-142
Hull City,2012-13,2013,0,65,0,73,0,139,0,-66
Hull City,1993-94,1994,0,0,0,0,0,0,0,0
Hull City,2004-05,2005,0,0,0,0,0,0,0,0
Hull City,2008-09,2009,35,35,39,39,64,64,-25,-25
Hull City,1994-95,1995,0,0,0,0,0,0,0,0
Hull City,1999-00,2000,0,0,0,0,0,0,0,0
Hull City,2020-21,2021,0,171,0,181,0,323,0,-142
Hull City,2009-10,2010,30,65,34,73,75,139,-41,-66
Hull City,2000-01,2001,0,0,0,0,0,0,0,0
Hull City,2013-14,2014,37,102,38,111,53,192,-15,-81
Hull City,2001-02,2002,0,0,0,0,0,0,0,0
Hull City,1997-98,1998,0,0,0,0,0,0,0,0
Hull City,2019-20,2020,0,171,0,181,0,323,0,-142
Hull City,2006-07,2007,0,0,0,0,0,0,0,0
Hull City,2022-23,2023,0,171,0,181,0,323,0,-142
Hull City,2011-12,2012,0,65,0,73,0,139,0,-66
Hull City,2018-19,2019,0,171,0,181,0,323,0,-142
Hull City,2014-15,2015,35,137,33,144,51,243,-18,-99
Hull City,2016-17,2017,34,171,37,181,80,323,-43,-142
Hull City,1998-99,1999,0,0,0,0,0,0,0,0
Hull City,2023-24,2024,0,171,0,181,0,323,0,-142
Burnley,2002-03,2003,0,0,0,0,0,0,0,0
Burnley,2010-11,2011,0,30,0,42,0,82,0,-40
Burnley,2003-04,2004,0,0,0,0,0,0,0,0
Burnley,2007-08,2008,0,0,0,0,0,0,0,0
Burnley,1995-96,1996,0,0,0,0,0,0,0,0
Burnley,2015-16,2016,0,63,0,70,0,135,0,-65
Burnley,1996-97,1997,0,0,0,0,0,0,0,0
Burnley,2005-06,2006,0,0,0,0,0,0,0,0
Burnley,1992-93,1993,0,0,0,0,0,0,0,0
Burnley,2017-18,2018,54,157,36,145,39,229,-3,-84
Burnley,2021-22,2022,35,325,34,300,53,455,-19,-155
Burnley,2012-13,2013,0,30,0,42,0,82,0,-40
Burnley,1993-94,1994,0,0,0,0,0,0,0,0
Burnley,2004-05,2005,0,0,0,0,0,0,0,0
Burnley,2008-09,2009,0,0,0,0,0,0,0,0
Burnley,1994-95,1995,0,0,0,0,0,0,0,0
Burnley,1999-00,2000,0,0,0,0,0,0,0,0
Burnley,2020-21,2021,39,290,33,266,55,402,-22,-136
Burnley,2009-10,2010,30,30,42,42,82,82,-40,-40
Burnley,2000-01,2001,0,0,0,0,0,0,0,0
Burnley,2013-14,2014,0,30,0,42,0,82,0,-40
Burnley,2001-02,2002,0,0,0,0,0,0,0,0
Burnley,1997-98,1998,0,0,0,0,0,0,0,0
Burnley,2019-20,2020,54,251,43,233,50,347,-7,-114
Burnley,2006-07,2007,0,0,0,0,0,0,0,0
Burnley,2022-23,2023,0,325,0,300,0,455,0,-155
Burnley,2011-12,2012,0,30,0,42,0,82,0,-40
Burnley,2018-19,2019,40,197,45,190,68,297,-23,-107
Burnley,2014-15,2015,33,63,28,70,53,135,-25,-65
Burnley,2016-17,2017,40,103,39,109,55,190,-16,-81
Burnley,1998-99,1999,0,0,0,0,0,0,0,0
Burnley,2023-24,2024,24,349,41,341,78,533,-37,-192
Bradford City,2002-03,2003,0,62,0,68,0,138,0,-70
Bradford City,2010-11,2011,0,62,0,68,0,138,0,-70
Bradford City,2003-04,2004,0,62,0,68,0,138,0,-70
Bradford City,2007-08,2008,0,62,0,68,0,138,0,-70
Bradford City,1995-96,1996,0,0,0,0,0,0,0,0
Bradford City,2015-16,2016,0,62,0,68,0,138,0,-70
Bradford City,1996-97,1997,0,0,0,0,0,0,0,0
Bradford City,2005-06,2006,0,62,0,68,0,138,0,-70
Bradford City,1992-93,1993,0,0,0,0,0,0,0,0
Bradford City,2017-18,2018,0,62,0,68,0,138,0,-70
Bradford City,2021-22,2022,0,62,0,68,0,138,0,-70
Bradford City,2012-13,2013,0,62,0,68,0,138,0,-70
Bradford City,1993-94,1994,0,0,0,0,0,0,0,0
Bradford City,2004-05,2005,0,62,0,68,0,138,0,-70
Bradford City,2008-09,2009,0,62,0,68,0,138,0,-70
Bradford City,1994-95,1995,0,0,0,0,0,0,0,0
Bradford City,1999-00,2000,36,36,38,38,68,68,-30,-30
Bradford City,2020-21,2021,0,62,0,68,0,138,0,-70
Bradford City,2009-10,2010,0,62,0,68,0,138,0,-70
Bradford City,2000-01,2001,26,62,30,68,70,138,-40,-70
Bradford City,2013-14,2014,0,62,0,68,0,138,0,-70
Bradford City,2001-02,2002,0,62,0,68,0,138,0,-70
Bradford City,1997-98,1998,0,0,0,0,0,0,0,0
Bradford City,2019-20,2020,0,62,0,68,0,138,0,-70
Bradford City,2006-07,2007,0,62,0,68,0,138,0,-70
Bradford City,2022-23,2023,0,62,0,68,0,138,0,-70
Bradford City,2011-12,2012,0,62,0,68,0,138,0,-70
Bradford City,2018-19,2019,0,62,0,68,0,138,0,-70
Bradford City,2014-15,2015,0,62,0,68,0,138,0,-70
Bradford City,2016-17,2017,0,62,0,68,0,138,0,-70
Bradford City,1998-99,1999,0,0,0,0,0,0,0,0
Bradford City,2023-24,2024,0,62,0,68,0,138,0,-70
QPR,2002-03,2003,0,216,0,224,0,232,0,-8
QPR,2010-11,2011,0,216,0,224,0,232,0,-8
QPR,2003-04,2004,0,216,0,224,0,232,0,-8
QPR,2007-08,2008,0,216,0,224,0,232,0,-8
QPR,1995-96,1996,33,216,38,224,57,232,-19,-8
QPR,2015-16,2016,0,308,0,339,0,431,0,-92
QPR,1996-97,1997,0,216,0,224,0,232,0,-8
QPR,2005-06,2006,0,216,0,224,0,232,0,-8
QPR,1992-93,1993,63,63,63,63,55,55,8,8
QPR,2017-18,2018,0,308,0,339,0,431,0,-92
QPR,2021-22,2022,0,308,0,339,0,431,0,-92
QPR,2012-13,2013,25,278,30,297,60,358,-30,-61
QPR,1993-94,1994,60,123,62,125,61,116,1,9
QPR,2004-05,2005,0,216,0,224,0,232,0,-8
QPR,2008-09,2009,0,216,0,224,0,232,0,-8
QPR,1994-95,1995,60,183,61,186,59,175,2,11
QPR,1999-00,2000,0,216,0,224,0,232,0,-8
QPR,2020-21,2021,0,308,0,339,0,431,0,-92
QPR,2009-10,2010,0,216,0,224,0,232,0,-8
QPR,2000-01,2001,0,216,0,224,0,232,0,-8
QPR,2013-14,2014,0,278,0,297,0,358,0,-61
QPR,2001-02,2002,0,216,0,224,0,232,0,-8
QPR,1997-98,1998,0,216,0,224,0,232,0,-8
QPR,2019-20,2020,0,308,0,339,0,431,0,-92
QPR,2006-07,2007,0,216,0,224,0,232,0,-8
QPR,2022-23,2023,0,308,0,339,0,431,0,-92
QPR,2011-12,2012,37,253,43,267,66,298,-23,-31
QPR,2018-19,2019,0,308,0,339,0,431,0,-92
QPR,2014-15,2015,30,308,42,339,73,431,-31,-92
QPR,2016-17,2017,0,308,0,339,0,431,0,-92
QPR,1998-99,1999,0,216,0,224,0,232,0,-8
QPR,2023-24,2024,0,308,0,339,0,431,0,-92
Stoke City,2002-03,2003,0,0,0,0,0,0,0,0
Stoke City,2010-11,2011,46,138,46,118,48,151,-2,-33
Stoke City,2003-04,2004,0,0,0,0,0,0,0,0
Stoke City,2007-08,2008,0,0,0,0,0,0,0,0
Stoke City,1995-96,1996,0,0,0,0,0,0,0,0
Stoke City,2015-16,2016,51,380,41,322,55,401,-14,-79
Stoke City,1996-97,1997,0,0,0,0,0,0,0,0
Stoke City,2005-06,2006,0,0,0,0,0,0,0,0
Stoke City,1992-93,1993,0,0,0,0,0,0,0,0
Stoke City,2017-18,2018,33,457,35,398,68,525,-33,-127
Stoke City,2021-22,2022,0,457,0,398,0,525,0,-127
Stoke City,2012-13,2013,42,225,34,188,45,249,-11,-61
Stoke City,1993-94,1994,0,0,0,0,0,0,0,0
Stoke City,2004-05,2005,0,0,0,0,0,0,0,0
Stoke City,2008-09,2009,45,45,38,38,55,55,-17,-17
Stoke City,1994-95,1995,0,0,0,0,0,0,0,0
Stoke City,1999-00,2000,0,0,0,0,0,0,0,0
Stoke City,2020-21,2021,0,457,0,398,0,525,0,-127
Stoke City,2009-10,2010,47,92,34,72,48,103,-14,-31
Stoke City,2000-01,2001,0,0,0,0,0,0,0,0
Stoke City,2013-14,2014,50,275,45,233,52,301,-7,-68
Stoke City,2001-02,2002,0,0,0,0,0,0,0,0
Stoke City,1997-98,1998,0,0,0,0,0,0,0,0
Stoke City,2019-20,2020,0,457,0,398,0,525,0,-127
Stoke City,2006-07,2007,0,0,0,0,0,0,0,0
Stoke City,2022-23,2023,0,457,0,398,0,525,0,-127
Stoke City,2011-12,2012,45,183,36,154,53,204,-17,-50
Stoke City,2018-19,2019,0,457,0,398,0,525,0,-127
Stoke City,2014-15,2015,54,329,48,281,45,346,3,-65
Stoke City,2016-17,2017,44,424,41,363,56,457,-15,-94
Stoke City,1998-99,1999,0,0,0,0,0,0,0,0
Stoke City,2023-24,2024,0,457,0,398,0,525,0,-127
Blackburn,2002-03,2003,60,546,52,516,43,409,9,107
Blackburn,2010-11,2011,43,939,46,879,59,829,-13,50
Blackburn,2003-04,2004,44,590,51,567,59,468,-8,99
Blackburn,2007-08,2008,58,805,50,752,48,655,2,97
Blackburn,1995-96,1996,61,305,61,272,47,168,14,104
Blackburn,2015-16,2016,0,970,0,927,0,907,0,20
Blackburn,1996-97,1997,42,347,42,314,43,211,-1,103
Blackburn,2005-06,2006,63,695,51,650,42,553,9,97
Blackburn,1992-93,1993,71,71,68,68,46,46,22,22
Blackburn,2017-18,2018,0,970,0,927,0,907,0,20
Blackburn,2021-22,2022,0,970,0,927,0,907,0,20
Blackburn,2012-13,2013,0,970,0,927,0,907,0,20
Blackburn,1993-94,1994,84,155,63,131,36,82,27,49
Blackburn,2004-05,2005,42,632,32,599,43,511,-11,88
Blackburn,2008-09,2009,41,846,40,792,60,715,-20,77
Blackburn,1994-95,1995,89,244,80,211,39,121,41,90
Blackburn,1999-00,2000,0,440,0,409,0,315,0,94
Blackburn,2020-21,2021,0,970,0,927,0,907,0,20
Blackburn,2009-10,2010,50,896,41,833,55,770,-14,63
Blackburn,2000-01,2001,0,440,0,409,0,315,0,94
Blackburn,2013-14,2014,0,970,0,927,0,907,0,20
Blackburn,2001-02,2002,46,486,55,464,51,366,4,98
Blackburn,1997-98,1998,58,405,57,371,52,263,5,108
Blackburn,2019-20,2020,0,970,0,927,0,907,0,20
Blackburn,2006-07,2007,52,747,52,702,54,607,-2,95
Blackburn,2022-23,2023,0,970,0,927,0,907,0,20
Blackburn,2011-12,2012,31,970,48,927,78,907,-30,20
Blackburn,2018-19,2019,0,970,0,927,0,907,0,20
Blackburn,2014-15,2015,0,970,0,927,0,907,0,20
Blackburn,2016-17,2017,0,970,0,927,0,907,0,20
Blackburn,1998-99,1999,35,440,38,409,52,315,-14,94
Blackburn,2023-24,2024,0,970,0,927,0,907,0,20
Cardiff City,2002-03,2003,0,0,0,0,0,0,0,0
Cardiff City,2010-11,2011,0,0,0,0,0,0,0,0
Cardiff City,2003-04,2004,0,0,0,0,0,0,0,0
Cardiff City,2007-08,2008,0,0,0,0,0,0,0,0
Cardiff City,1995-96,1996,0,0,0,0,0,0,0,0
Cardiff City,2015-16,2016,0,30,0,32,0,74,0,-42
Cardiff City,1996-97,1997,0,0,0,0,0,0,0,0
Cardiff City,2005-06,2006,0,0,0,0,0,0,0,0
Cardiff City,1992-93,1993,0,0,0,0,0,0,0,0
Cardiff City,2017-18,2018,0,30,0,32,0,74,0,-42
Cardiff City,2021-22,2022,0,64,0,66,0,143,0,-77
Cardiff City,2012-13,2013,0,0,0,0,0,0,0,0
Cardiff City,1993-94,1994,0,0,0,0,0,0,0,0
Cardiff City,2004-05,2005,0,0,0,0,0,0,0,0
Cardiff City,2008-09,2009,0,0,0,0,0,0,0,0
Cardiff City,1994-95,1995,0,0,0,0,0,0,0,0
Cardiff City,1999-00,2000,0,0,0,0,0,0,0,0
Cardiff City,2020-21,2021,0,64,0,66,0,143,0,-77
Cardiff City,2009-10,2010,0,0,0,0,0,0,0,0
Cardiff City,2000-01,2001,0,0,0,0,0,0,0,0
Cardiff City,2013-14,2014,30,30,32,32,74,74,-42,-42
Cardiff City,2001-02,2002,0,0,0,0,0,0,0,0
Cardiff City,1997-98,1998,0,0,0,0,0,0,0,0
Cardiff City,2019-20,2020,0,64,0,66,0,143,0,-77
Cardiff City,2006-07,2007,0,0,0,0,0,0,0,0
Cardiff City,2022-23,2023,0,64,0,66,0,143,0,-77
Cardiff City,2011-12,2012,0,0,0,0,0,0,0,0
Cardiff City,2018-19,2019,34,64,34,66,69,143,-35,-77
Cardiff City,2014-15,2015,0,30,0,32,0,74,0,-42
Cardiff City,2016-17,2017,0,30,0,32,0,74,0,-42
Cardiff City,1998-99,1999,0,0,0,0,0,0,0,0
Cardiff City,2023-24,2024,0,64,0,66,0,143,0,-77
Swindon Town,2002-03,2003,0,30,0,47,0,100,0,-53
Swindon Town,2010-11,2011,0,30,0,47,0,100,0,-53
Swindon Town,2003-04,2004,0,30,0,47,0,100,0,-53
Swindon Town,2007-08,2008,0,30,0,47,0,100,0,-53
Swindon Town,1995-96,1996,0,30,0,47,0,100,0,-53
Swindon Town,2015-16,2016,0,30,0,47,0,100,0,-53
Swindon Town,1996-97,1997,0,30,0,47,0,100,0,-53
Swindon Town,2005-06,2006,0,30,0,47,0,100,0,-53
Swindon Town,1992-93,1993,0,0,0,0,0,0,0,0
Swindon Town,2017-18,2018,0,30,0,47,0,100,0,-53
Swindon Town,2021-22,2022,0,30,0,47,0,100,0,-53
Swindon Town,2012-13,2013,0,30,0,47,0,100,0,-53
Swindon Town,1993-94,1994,30,30,47,47,100,100,-53,-53
Swindon Town,2004-05,2005,0,30,0,47,0,100,0,-53
Swindon Town,2008-09,2009,0,30,0,47,0,100,0,-53
Swindon Town,1994-95,1995,0,30,0,47,0,100,0,-53
Swindon Town,1999-00,2000,0,30,0,47,0,100,0,-53
Swindon Town,2020-21,2021,0,30,0,47,0,100,0,-53
Swindon Town,2009-10,2010,0,30,0,47,0,100,0,-53
Swindon Town,2000-01,2001,0,30,0,47,0,100,0,-53
Swindon Town,2013-14,2014,0,30,0,47,0,100,0,-53
Swindon Town,2001-02,2002,0,30,0,47,0,100,0,-53
Swindon Town,1997-98,1998,0,30,0,47,0,100,0,-53
Swindon Town,2019-20,2020,0,30,0,47,0,100,0,-53
Swindon Town,2006-07,2007,0,30,0,47,0,100,0,-53
Swindon Town,2022-23,2023,0,30,0,47,0,100,0,-53
Swindon Town,2011-12,2012,0,30,0,47,0,100,0,-53
Swindon Town,2018-19,2019,0,30,0,47,0,100,0,-53
Swindon Town,2014-15,2015,0,30,0,47,0,100,0,-53
Swindon Town,2016-17,2017,0,30,0,47,0,100,0,-53
Swindon Town,1998-99,1999,0,30,0,47,0,100,0,-53
Swindon Town,2023-24,2024,0,30,0,47,0,100,0,-53
Bournemouth,2002-03,2003,0,0,0,0,0,0,0,0
Bournemouth,2010-11,2011,0,0,0,0,0,0,0,0
Bournemouth,2003-04,2004,0,0,0,0,0,0,0,0
Bournemouth,2007-08,2008,0,0,0,0,0,0,0,0
Bournemouth,1995-96,1996,0,0,0,0,0,0,0,0
Bournemouth,2015-16,2016,42,42,45,45,67,67,-22,-22
Bournemouth,1996-97,1997,0,0,0,0,0,0,0,0
Bournemouth,2005-06,2006,0,0,0,0,0,0,0,0
Bournemouth,1992-93,1993,0,0,0,0,0,0,0,0
Bournemouth,2017-18,2018,44,132,45,145,61,195,-16,-50
Bournemouth,2021-22,2022,0,211,0,241,0,330,0,-89
Bournemouth,2012-13,2013,0,0,0,0,0,0,0,0
Bournemouth,1993-94,1994,0,0,0,0,0,0,0,0
Bournemouth,2004-05,2005,0,0,0,0,0,0,0,0
Bournemouth,2008-09,2009,0,0,0,0,0,0,0,0
Bournemouth,1994-95,1995,0,0,0,0,0,0,0,0
Bournemouth,1999-00,2000,0,0,0,0,0,0,0,0
Bournemouth,2020-21,2021,0,211,0,241,0,330,0,-89
Bournemouth,2009-10,2010,0,0,0,0,0,0,0,0
Bournemouth,2000-01,2001,0,0,0,0,0,0,0,0
Bournemouth,2013-14,2014,0,0,0,0,0,0,0,0
Bournemouth,2001-02,2002,0,0,0,0,0,0,0,0
Bournemouth,1997-98,1998,0,0,0,0,0,0,0,0
Bournemouth,2019-20,2020,34,211,40,241,65,330,-25,-89
Bournemouth,2006-07,2007,0,0,0,0,0,0,0,0
Bournemouth,2022-23,2023,39,250,37,278,71,401,-34,-123
Bournemouth,2011-12,2012,0,0,0,0,0,0,0,0
Bournemouth,2018-19,2019,45,177,56,201,70,265,-14,-64
Bournemouth,2014-15,2015,0,0,0,0,0,0,0,0
Bournemouth,2016-17,2017,46,88,55,100,67,134,-12,-34
Bournemouth,1998-99,1999,0,0,0,0,0,0,0,0
Bournemouth,2023-24,2024,48,298,54,332,67,468,-13,-136
Liverpool,2002-03,2003,64,731,61,704,41,449,20,255
Liverpool,2010-11,2011,58,1282,59,1189,44,713,15,476
Liverpool,2003-04,2004,60,791,55,759,37,486,18,273
Liverpool,2007-08,2008,76,1075,67,992,28,607,39,385
Liverpool,1995-96,1996,71,264,70,256,34,181,36,75
Liverpool,2015-16,2016,60,1601,63,1523,50,944,13,579
Liverpool,1996-97,1997,68,332,62,318,37,218,25,100
Liverpool,2005-06,2006,82,931,57,868,25,552,32,316
Liverpool,1992-93,1993,59,59,62,62,55,55,7,7
Liverpool,2017-18,2018,75,1752,84,1685,38,1024,46,661
Liverpool,2021-22,2022,92,2109,94,2021,26,1147,68,874
Liverpool,2012-13,2013,61,1395,71,1307,43,796,28,511
Liverpool,1993-94,1994,60,119,59,121,55,110,4,11
Liverpool,2004-05,2005,58,849,52,811,41,527,11,284
Liverpool,2008-09,2009,86,1161,77,1069,27,634,50,435
Liverpool,1994-95,1995,74,193,65,186,37,147,28,39
Liverpool,1999-00,2000,67,518,51,505,30,339,21,166
Liverpool,2020-21,2021,69,2017,68,1927,42,1121,26,806
Liverpool,2009-10,2010,63,1224,61,1130,35,669,26,461
Liverpool,2000-01,2001,69,587,71,576,39,378,32,198
Liverpool,2013-14,2014,84,1479,101,1408,50,846,51,562
Liverpool,2001-02,2002,80,667,67,643,30,408,37,235
Liverpool,1997-98,1998,65,397,68,386,42,260,26,126
Liverpool,2019-20,2020,99,1948,85,1859,33,1079,52,780
Liverpool,2006-07,2007,68,999,57,925,27,579,30,346
Liverpool,2022-23,2023,67,2176,75,2096,47,1194,28,902
Liverpool,2011-12,2012,52,1334,47,1236,40,753,7,483
Liverpool,2018-19,2019,97,1849,89,1774,22,1046,67,728
Liverpool,2014-15,2015,62,1541,52,1460,48,894,4,566
Liverpool,2016-17,2017,76,1677,78,1601,42,986,36,615
Liverpool,1998-99,1999,54,451,68,454,49,309,19,145
Liverpool,2023-24,2024,82,2258,86,2182,41,1235,45,947
Leicester City,2002-03,2003,0,309,0,306,0,391,0,-85
Leicester City,2010-11,2011,0,342,0,354,0,456,0,-102
Leicester City,2003-04,2004,33,342,48,354,65,456,-17,-102
Leicester City,2007-08,2008,0,342,0,354,0,456,0,-102
Leicester City,1995-96,1996,0,29,0,45,0,80,0,-35
Leicester City,2015-16,2016,81,464,68,468,36,547,32,-79
Leicester City,1996-97,1997,47,76,46,91,54,134,-8,-43
Leicester City,2005-06,2006,0,342,0,354,0,456,0,-102
Leicester City,1992-93,1993,0,0,0,0,0,0,0,0
Leicester City,2017-18,2018,47,555,56,572,60,670,-4,-98
Leicester City,2021-22,2022,52,787,62,820,59,868,3,-48
Leicester City,2012-13,2013,0,342,0,354,0,456,0,-102
Leicester City,1993-94,1994,0,0,0,0,0,0,0,0
Leicester City,2004-05,2005,0,342,0,354,0,456,0,-102
Leicester City,2008-09,2009,0,342,0,354,0,456,0,-102
Leicester City,1994-95,1995,29,29,45,45,80,80,-35,-35
Leicester City,1999-00,2000,55,233,55,237,55,276,0,-39
Leicester City,2020-21,2021,66,735,68,758,50,809,18,-51
Leicester City,2009-10,2010,0,342,0,354,0,456,0,-102
Leicester City,2000-01,2001,48,281,39,276,51,327,-12,-51
Leicester City,2013-14,2014,0,342,0,354,0,456,0,-102
Leicester City,2001-02,2002,28,309,30,306,64,391,-34,-85
Leicester City,1997-98,1998,53,129,51,142,41,175,10,-33
Leicester City,2019-20,2020,62,669,67,690,41,759,26,-69
Leicester City,2006-07,2007,0,342,0,354,0,456,0,-102
Leicester City,2022-23,2023,34,821,51,871,68,936,-17,-65
Leicester City,2011-12,2012,0,342,0,354,0,456,0,-102
Leicester City,2018-19,2019,52,607,51,623,48,718,3,-95
Leicester City,2014-15,2015,41,383,46,400,55,511,-9,-111
Leicester City,2016-17,2017,44,508,48,516,63,610,-15,-94
Leicester City,1998-99,1999,49,178,40,182,46,221,-6,-39
Leicester City,2023-24,2024,0,821,0,871,0,936,0,-65
Huddersfield,2002-03,2003,0,0,0,0,0,0,0,0
Huddersfield,2010-11,2011,0,0,0,0,0,0,0,0
Huddersfield,2003-04,2004,0,0,0,0,0,0,0,0
Huddersfield,2007-08,2008,0,0,0,0,0,0,0,0
Huddersfield,1995-96,1996,0,0,0,0,0,0,0,0
Huddersfield,2015-16,2016,0,0,0,0,0,0,0,0
Huddersfield,1996-97,1997,0,0,0,0,0,0,0,0
Huddersfield,2005-06,2006,0,0,0,0,0,0,0,0
Huddersfield,1992-93,1993,0,0,0,0,0,0,0,0
Huddersfield,2017-18,2018,37,37,28,28,58,58,-30,-30
Huddersfield,2021-22,2022,0,53,0,50,0,134,0,-84
Huddersfield,2012-13,2013,0,0,0,0,0,0,0,0
Huddersfield,1993-94,1994,0,0,0,0,0,0,0,0
Huddersfield,2004-05,2005,0,0,0,0,0,0,0,0
Huddersfield,2008-09,2009,0,0,0,0,0,0,0,0
Huddersfield,1994-95,1995,0,0,0,0,0,0,0,0
Huddersfield,1999-00,2000,0,0,0,0,0,0,0,0
Huddersfield,2020-21,2021,0,53,0,50,0,134,0,-84
Huddersfield,2009-10,2010,0,0,0,0,0,0,0,0
Huddersfield,2000-01,2001,0,0,0,0,0,0,0,0
Huddersfield,2013-14,2014,0,0,0,0,0,0,0,0
Huddersfield,2001-02,2002,0,0,0,0,0,0,0,0
Huddersfield,1997-98,1998,0,0,0,0,0,0,0,0
Huddersfield,2019-20,2020,0,53,0,50,0,134,0,-84
Huddersfield,2006-07,2007,0,0,0,0,0,0,0,0
Huddersfield,2022-23,2023,0,53,0,50,0,134,0,-84
Huddersfield,2011-12,2012,0,0,0,0,0,0,0,0
Huddersfield,2018-19,2019,16,53,22,50,76,134,-54,-84
Huddersfield,2014-15,2015,0,0,0,0,0,0,0,0
Huddersfield,2016-17,2017,0,0,0,0,0,0,0,0
Huddersfield,1998-99,1999,0,0,0,0,0,0,0,0
Huddersfield,2023-24,2024,0,53,0,50,0,134,0,-84
Ipswich Town,2002-03,2003,0,224,0,219,0,312,0,-93
Ipswich Town,2010-11,2011,0,224,0,219,0,312,0,-93
Ipswich Town,2003-04,2004,0,224,0,219,0,312,0,-93
Ipswich Town,2007-08,2008,0,224,0,219,0,312,0,-93
Ipswich Town,1995-96,1996,0,122,0,121,0,206,0,-85
Ipswich Town,2015-16,2016,0,224,0,219,0,312,0,-93
Ipswich Town,1996-97,1997,0,122,0,121,0,206,0,-85
Ipswich Town,2005-06,2006,0,224,0,219,0,312,0,-93
Ipswich Town,1992-93,1993,52,52,50,50,55,55,-5,-5
Ipswich Town,2017-18,2018,0,224,0,219,0,312,0,-93
Ipswich Town,2021-22,2022,0,224,0,219,0,312,0,-93
Ipswich Town,2012-13,2013,0,224,0,219,0,312,0,-93
Ipswich Town,1993-94,1994,43,95,35,85,58,113,-23,-28
Ipswich Town,2004-05,2005,0,224,0,219,0,312,0,-93
Ipswich Town,2008-09,2009,0,224,0,219,0,312,0,-93
Ipswich Town,1994-95,1995,27,122,36,121,93,206,-57,-85
Ipswich Town,1999-00,2000,0,122,0,121,0,206,0,-85
Ipswich Town,2020-21,2021,0,224,0,219,0,312,0,-93
Ipswich Town,2009-10,2010,0,224,0,219,0,312,0,-93
Ipswich Town,2000-01,2001,66,188,57,178,42,248,15,-70
Ipswich Town,2013-14,2014,0,224,0,219,0,312,0,-93
Ipswich Town,2001-02,2002,36,224,41,219,64,312,-23,-93
Ipswich Town,1997-98,1998,0,122,0,121,0,206,0,-85
Ipswich Town,2019-20,2020,0,224,0,219,0,312,0,-93
Ipswich Town,2006-07,2007,0,224,0,219,0,312,0,-93
Ipswich Town,2022-23,2023,0,224,0,219,0,312,0,-93
Ipswich Town,2011-12,2012,0,224,0,219,0,312,0,-93
Ipswich Town,2018-19,2019,0,224,0,219,0,312,0,-93
Ipswich Town,2014-15,2015,0,224,0,219,0,312,0,-93
Ipswich Town,2016-17,2017,0,224,0,219,0,312,0,-93
Ipswich Town,1998-99,1999,0,122,0,121,0,206,0,-85
Ipswich Town,2023-24,2024,0,224,0,219,0,312,0,-93
Brentford,2002-03,2003,0,0,0,0,0,0,0,0
Brentford,2010-11,2011,0,0,0,0,0,0,0,0
Brentford,2003-04,2004,0,0,0,0,0,0,0,0
Brentford,2007-08,2008,0,0,0,0,0,0,0,0
Brentford,1995-96,1996,0,0,0,0,0,0,0,0
Brentford,2015-16,2016,0,0,0,0,0,0,0,0
Brentford,1996-97,1997,0,0,0,0,0,0,0,0
Brentford,2005-06,2006,0,0,0,0,0,0,0,0
Brentford,1992-93,1993,0,0,0,0,0,0,0,0
Brentford,2017-18,2018,0,0,0,0,0,0,0,0
Brentford,2021-22,2022,46,46,48,48,56,56,-8,-8
Brentford,2012-13,2013,0,0,0,0,0,0,0,0
Brentford,1993-94,1994,0,0,0,0,0,0,0,0
Brentford,2004-05,2005,0,0,0,0,0,0,0,0
Brentford,2008-09,2009,0,0,0,0,0,0,0,0
Brentford,1994-95,1995,0,0,0,0,0,0,0,0
Brentford,1999-00,2000,0,0,0,0,0,0,0,0
Brentford,2020-21,2021,0,0,0,0,0,0,0,0
Brentford,2009-10,2010,0,0,0,0,0,0,0,0
Brentford,2000-01,2001,0,0,0,0,0,0,0,0
Brentford,2013-14,2014,0,0,0,0,0,0,0,0
Brentford,2001-02,2002,0,0,0,0,0,0,0,0
Brentford,1997-98,1998,0,0,0,0,0,0,0,0
Brentford,2019-20,2020,0,0,0,0,0,0,0,0
Brentford,2006-07,2007,0,0,0,0,0,0,0,0
Brentford,2022-23,2023,59,105,58,106,46,102,12,4
Brentford,2011-12,2012,0,0,0,0,0,0,0,0
Brentford,2018-19,2019,0,0,0,0,0,0,0,0
Brentford,2014-15,2015,0,0,0,0,0,0,0,0
Brentford,2016-17,2017,0,0,0,0,0,0,0,0
Brentford,1998-99,1999,0,0,0,0,0,0,0,0
Brentford,2023-24,2024,39,144,56,162,65,167,-9,-5
Aston Villa,2002-03,2003,45,622,42,533,47,481,-5,52
Aston Villa,2010-11,2011,48,1051,48,936,59,870,-11,66
Aston Villa,2003-04,2004,56,678,48,581,44,525,4,56
Aston Villa,2007-08,2008,60,877,71,782,51,724,20,58
Aston Villa,1995-96,1996,63,242,52,206,35,181,17,25
Aston Villa,2015-16,2016,17,1223,27,1117,76,1186,-49,-69
Aston Villa,1996-97,1997,61,303,47,253,34,215,13,38
Aston Villa,2005-06,2006,42,767,42,668,55,632,-13,36
Aston Villa,1992-93,1993,74,74,57,57,40,40,17,17
Aston Villa,2017-18,2018,0,1223,0,1117,0,1186,0,-69
Aston Villa,2021-22,2022,45,1358,52,1265,54,1353,-2,-88
Aston Villa,2012-13,2013,41,1130,47,1020,69,992,-22,28
Aston Villa,1993-94,1994,57,131,46,103,50,90,-4,13
Aston Villa,2004-05,2005,47,725,45,626,52,577,-7,49
Aston Villa,2008-09,2009,62,939,54,836,48,772,6,64
Aston Villa,1994-95,1995,48,179,51,154,56,146,-5,8
Aston Villa,1999-00,2000,58,473,46,399,35,344,11,55
Aston Villa,2020-21,2021,55,1313,55,1213,46,1299,9,-86
Aston Villa,2009-10,2010,64,1003,52,888,39,811,13,77
Aston Villa,2000-01,2001,54,527,46,445,43,387,3,58
Aston Villa,2013-14,2014,38,1168,39,1059,61,1053,-22,6
Aston Villa,2001-02,2002,50,577,46,491,47,434,-1,57
Aston Villa,1997-98,1998,57,360,49,302,48,263,1,39
Aston Villa,2019-20,2020,35,1258,41,1158,67,1253,-26,-95
Aston Villa,2006-07,2007,50,817,43,711,41,673,2,38
Aston Villa,2022-23,2023,61,1419,51,1316,46,1399,5,-83
Aston Villa,2011-12,2012,38,1089,37,973,53,923,-16,50
Aston Villa,2018-19,2019,0,1223,0,1117,0,1186,0,-69
Aston Villa,2014-15,2015,38,1206,31,1090,57,1110,-26,-20
Aston Villa,2016-17,2017,0,1223,0,1117,0,1186,0,-69
Aston Villa,1998-99,1999,55,415,51,353,46,309,5,44
Aston Villa,2023-24,2024,68,1487,76,1392,61,1460,15,-68
Norwich City,2002-03,2003,0,168,0,163,0,180,0,-17
Norwich City,2010-11,2011,0,201,0,205,0,257,0,-52
Norwich City,2003-04,2004,0,168,0,163,0,180,0,-17
Norwich City,2007-08,2008,0,201,0,205,0,257,0,-52
Norwich City,1995-96,1996,0,168,0,163,0,180,0,-17
Norwich City,2015-16,2016,34,359,39,365,67,510,-28,-145
Norwich City,1996-97,1997,0,168,0,163,0,180,0,-17
Norwich City,2005-06,2006,0,201,0,205,0,257,0,-52
Norwich City,1992-93,1993,72,72,61,61,65,65,-4,-4
Norwich City,2017-18,2018,0,359,0,365,0,510,0,-145
Norwich City,2021-22,2022,22,402,23,414,84,669,-61,-255
Norwich City,2012-13,2013,44,292,41,298,58,381,-17,-83
Norwich City,1993-94,1994,53,125,65,126,61,126,4,0
Norwich City,2004-05,2005,33,201,42,205,77,257,-35,-52
Norwich City,2008-09,2009,0,201,0,205,0,257,0,-52
Norwich City,1994-95,1995,43,168,37,163,54,180,-17,-17
Norwich City,1999-00,2000,0,168,0,163,0,180,0,-17
Norwich City,2020-21,2021,0,380,0,391,0,585,0,-194
Norwich City,2009-10,2010,0,201,0,205,0,257,0,-52
Norwich City,2000-01,2001,0,168,0,163,0,180,0,-17
Norwich City,2013-14,2014,33,325,28,326,62,443,-34,-117
Norwich City,2001-02,2002,0,168,0,163,0,180,0,-17
Norwich City,1997-98,1998,0,168,0,163,0,180,0,-17
Norwich City,2019-20,2020,21,380,26,391,75,585,-49,-194
Norwich City,2006-07,2007,0,201,0,205,0,257,0,-52
Norwich City,2022-23,2023,0,402,0,414,0,669,0,-255
Norwich City,2011-12,2012,47,248,52,257,66,323,-14,-66
Norwich City,2018-19,2019,0,359,0,365,0,510,0,-145
Norwich City,2014-15,2015,0,325,0,326,0,443,0,-117
Norwich City,2016-17,2017,0,359,0,365,0,510,0,-145
Norwich City,1998-99,1999,0,168,0,163,0,180,0,-17
Norwich City,2023-24,2024,0,402,0,414,0,669,0,-255
Tottenham,2002-03,2003,50,566,51,569,62,596,-11,-27
Tottenham,2010-11,2011,62,1017,55,1006,46,979,9,27
Tottenham,2003-04,2004,45,611,47,616,57,653,-10,-37
Tottenham,2007-08,2008,46,834,66,839,61,847,5,-8
Tottenham,1995-96,1996,61,227,50,230,38,221,12,9
Tottenham,2015-16,2016,70,1361,69,1320,35,1205,34,115
Tottenham,1996-97,1997,46,273,44,274,51,272,-7,2
Tottenham,2005-06,2006,65,728,53,716,38,732,15,-16
Tottenham,1992-93,1993,59,59,60,60,66,66,-6,-6
Tottenham,2017-18,2018,77,1524,74,1480,36,1267,38,213
Tottenham,2021-22,2022,71,1787,69,1745,40,1438,29,307
Tottenham,2012-13,2013,72,1158,66,1138,46,1066,20,72
Tottenham,1993-94,1994,45,104,54,114,59,125,-5,-11
Tottenham,2004-05,2005,52,663,47,663,41,694,6,-31
Tottenham,2008-09,2009,51,885,45,884,45,892,0,-8
Tottenham,1994-95,1995,62,166,66,180,58,183,8,-3
Tottenham,1999-00,2000,53,417,57,422,49,427,8,-5
Tottenham,2020-21,2021,62,1716,68,1676,45,1398,23,278
Tottenham,2009-10,2010,70,955,67,951,41,933,26,18
Tottenham,2000-01,2001,49,466,47,469,54,481,-7,-12
Tottenham,2013-14,2014,69,1227,55,1193,51,1117,4,76
Tottenham,2001-02,2002,50,516,49,518,53,534,-4,-16
Tottenham,1997-98,1998,44,317,44,318,56,328,-12,-10
Tottenham,2019-20,2020,59,1654,61,1608,47,1353,14,255
Tottenham,2006-07,2007,60,788,57,773,54,786,3,-13
Tottenham,2022-23,2023,60,1847,70,1815,63,1501,7,314
Tottenham,2011-12,2012,69,1086,66,1072,41,1020,25,52
Tottenham,2018-19,2019,71,1595,67,1547,39,1306,28,241
Tottenham,2014-15,2015,64,1291,58,1251,53,1170,5,81
Tottenham,2016-17,2017,86,1447,86,1406,26,1231,60,175
Tottenham,1998-99,1999,47,364,47,365,50,378,-3,-13
Tottenham,2023-24,2024,66,1913,74,1889,61,1562,13,327
Blackpool,2002-03,2003,0,0,0,0,0,0,0,0
Blackpool,2010-11,2011,39,39,55,55,78,78,-23,-23
Blackpool,2003-04,2004,0,0,0,0,0,0,0,0
Blackpool,2007-08,2008,0,0,0,0,0,0,0,0
Blackpool,1995-96,1996,0,0,0,0,0,0,0,0
Blackpool,2015-16,2016,0,39,0,55,0,78,0,-23
Blackpool,1996-97,1997,0,0,0,0,0,0,0,0
Blackpool,2005-06,2006,0,0,0,0,0,0,0,0
Blackpool,1992-93,1993,0,0,0,0,0,0,0,0
Blackpool,2017-18,2018,0,39,0,55,0,78,0,-23
Blackpool,2021-22,2022,0,39,0,55,0,78,0,-23
Blackpool,2012-13,2013,0,39,0,55,0,78,0,-23
Blackpool,1993-94,1994,0,0,0,0,0,0,0,0
Blackpool,2004-05,2005,0,0,0,0,0,0,0,0
Blackpool,2008-09,2009,0,0,0,0,0,0,0,0
Blackpool,1994-95,1995,0,0,0,0,0,0,0,0
Blackpool,1999-00,2000,0,0,0,0,0,0,0,0
Blackpool,2020-21,2021,0,39,0,55,0,78,0,-23
Blackpool,2009-10,2010,0,0,0,0,0,0,0,0
Blackpool,2000-01,2001,0,0,0,0,0,0,0,0
Blackpool,2013-14,2014,0,39,0,55,0,78,0,-23
Blackpool,2001-02,2002,0,0,0,0,0,0,0,0
Blackpool,1997-98,1998,0,0,0,0,0,0,0,0
Blackpool,2019-20,2020,0,39,0,55,0,78,0,-23
Blackpool,2006-07,2007,0,0,0,0,0,0,0,0
Blackpool,2022-23,2023,0,39,0,55,0,78,0,-23
Blackpool,2011-12,2012,0,39,0,55,0,78,0,-23
Blackpool,2018-19,2019,0,39,0,55,0,78,0,-23
Blackpool,2014-15,2015,0,39,0,55,0,78,0,-23
Blackpool,2016-17,2017,0,39,0,55,0,78,0,-23
Blackpool,1998-99,1999,0,0,0,0,0,0,0,0
Blackpool,2023-24,2024,0,39,0,55,0,78,0,-23
Crystal Palace,2002-03,2003,0,127,0,119,0,181,0,-62
Crystal Palace,2010-11,2011,0,160,0,160,0,243,0,-83
Crystal Palace,2003-04,2004,0,127,0,119,0,181,0,-62
Crystal Palace,2007-08,2008,0,160,0,160,0,243,0,-83
Crystal Palace,1995-96,1996,0,94,0,82,0,110,0,-28
Crystal Palace,2015-16,2016,42,295,39,279,51,393,-12,-114
Crystal Palace,1996-97,1997,0,94,0,82,0,110,0,-28
Crystal Palace,2005-06,2006,0,160,0,160,0,243,0,-83
Crystal Palace,1992-93,1993,49,49,48,48,61,61,-13,-13
Crystal Palace,2017-18,2018,44,380,45,374,55,511,-10,-137
Crystal Palace,2021-22,2022,48,564,50,547,46,726,4,-179
Crystal Palace,2012-13,2013,0,160,0,160,0,243,0,-83
Crystal Palace,1993-94,1994,0,49,0,48,0,61,0,-13
Crystal Palace,2004-05,2005,33,160,41,160,62,243,-21,-83
Crystal Palace,2008-09,2009,0,160,0,160,0,243,0,-83
Crystal Palace,1994-95,1995,45,94,34,82,49,110,-15,-28
Crystal Palace,1999-00,2000,0,127,0,119,0,181,0,-62
Crystal Palace,2020-21,2021,44,516,41,497,66,680,-25,-183
Crystal Palace,2009-10,2010,0,160,0,160,0,243,0,-83
Crystal Palace,2000-01,2001,0,127,0,119,0,181,0,-62
Crystal Palace,2013-14,2014,45,205,33,193,48,291,-15,-98
Crystal Palace,2001-02,2002,0,127,0,119,0,181,0,-62
Crystal Palace,1997-98,1998,33,127,37,119,71,181,-34,-62
Crystal Palace,2019-20,2020,43,472,31,456,50,614,-19,-158
Crystal Palace,2006-07,2007,0,160,0,160,0,243,0,-83
Crystal Palace,2022-23,2023,45,609,40,587,49,775,-9,-188
Crystal Palace,2011-12,2012,0,160,0,160,0,243,0,-83
Crystal Palace,2018-19,2019,49,429,51,425,53,564,-2,-139
Crystal Palace,2014-15,2015,48,253,47,240,51,342,-4,-102
Crystal Palace,2016-17,2017,41,336,50,329,63,456,-13,-127
Crystal Palace,1998-99,1999,0,127,0,119,0,181,0,-62
Crystal Palace,2023-24,2024,49,658,57,644,58,833,-1,-189
West Brom,2002-03,2003,26,26,29,29,65,65,-36,-36
West Brom,2010-11,2011,47,169,56,188,71,322,-15,-134
West Brom,2003-04,2004,0,26,0,29,0,65,0,-36
West Brom,2007-08,2008,0,90,0,96,0,184,0,-88
West Brom,1995-96,1996,0,0,0,0,0,0,0,0
West Brom,2015-16,2016,43,388,34,401,48,589,-14,-188
West Brom,1996-97,1997,0,0,0,0,0,0,0,0
West Brom,2005-06,2006,30,90,31,96,58,184,-27,-88
West Brom,1992-93,1993,0,0,0,0,0,0,0,0
West Brom,2017-18,2018,31,464,31,475,56,696,-25,-221
West Brom,2021-22,2022,0,490,0,510,0,772,0,-262
West Brom,2012-13,2013,49,265,53,286,57,431,-4,-145
West Brom,1993-94,1994,0,0,0,0,0,0,0,0
West Brom,2004-05,2005,34,60,36,65,61,126,-25,-61
West Brom,2008-09,2009,32,122,36,132,67,251,-31,-119
West Brom,1994-95,1995,0,0,0,0,0,0,0,0
West Brom,1999-00,2000,0,0,0,0,0,0,0,0
West Brom,2020-21,2021,26,490,35,510,76,772,-41,-262
West Brom,2009-10,2010,0,122,0,132,0,251,0,-119
West Brom,2000-01,2001,0,0,0,0,0,0,0,0
West Brom,2013-14,2014,36,301,43,329,59,490,-16,-161
West Brom,2001-02,2002,0,0,0,0,0,0,0,0
West Brom,1997-98,1998,0,0,0,0,0,0,0,0
West Brom,2019-20,2020,0,464,0,475,0,696,0,-221
West Brom,2006-07,2007,0,90,0,96,0,184,0,-88
West Brom,2022-23,2023,0,490,0,510,0,772,0,-262
West Brom,2011-12,2012,47,216,45,233,52,374,-7,-141
West Brom,2018-19,2019,0,464,0,475,0,696,0,-221
West Brom,2014-15,2015,44,345,38,367,51,541,-13,-174
West Brom,2016-17,2017,45,433,43,444,51,640,-8,-196
West Brom,1998-99,1999,0,0,0,0,0,0,0,0
West Brom,2023-24,2024,0,490,0,510,0,772,0,-262
Barnsley,2002-03,2003,0,35,0,37,0,82,0,-45
Barnsley,2010-11,2011,0,35,0,37,0,82,0,-45
Barnsley,2003-04,2004,0,35,0,37,0,82,0,-45
Barnsley,2007-08,2008,0,35,0,37,0,82,0,-45
Barnsley,1995-96,1996,0,0,0,0,0,0,0,0
Barnsley,2015-16,2016,0,35,0,37,0,82,0,-45
Barnsley,1996-97,1997,0,0,0,0,0,0,0,0
Barnsley,2005-06,2006,0,35,0,37,0,82,0,-45
Barnsley,1992-93,1993,0,0,0,0,0,0,0,0
Barnsley,2017-18,2018,0,35,0,37,0,82,0,-45
Barnsley,2021-22,2022,0,35,0,37,0,82,0,-45
Barnsley,2012-13,2013,0,35,0,37,0,82,0,-45
Barnsley,1993-94,1994,0,0,0,0,0,0,0,0
Barnsley,2004-05,2005,0,35,0,37,0,82,0,-45
Barnsley,2008-09,2009,0,35,0,37,0,82,0,-45
Barnsley,1994-95,1995,0,0,0,0,0,0,0,0
Barnsley,1999-00,2000,0,35,0,37,0,82,0,-45
Barnsley,2020-21,2021,0,35,0,37,0,82,0,-45
Barnsley,2009-10,2010,0,35,0,37,0,82,0,-45
Barnsley,2000-01,2001,0,35,0,37,0,82,0,-45
Barnsley,2013-14,2014,0,35,0,37,0,82,0,-45
Barnsley,2001-02,2002,0,35,0,37,0,82,0,-45
Barnsley,1997-98,1998,35,35,37,37,82,82,-45,-45
Barnsley,2019-20,2020,0,35,0,37,0,82,0,-45
Barnsley,2006-07,2007,0,35,0,37,0,82,0,-45
Barnsley,2022-23,2023,0,35,0,37,0,82,0,-45
Barnsley,2011-12,2012,0,35,0,37,0,82,0,-45
Barnsley,2018-19,2019,0,35,0,37,0,82,0,-45
Barnsley,2014-15,2015,0,35,0,37,0,82,0,-45
Barnsley,2016-17,2017,0,35,0,37,0,82,0,-45
Barnsley,1998-99,1999,0,35,0,37,0,82,0,-45
Barnsley,2023-24,2024,0,35,0,37,0,82,0,-45
Swansea City,2002-03,2003,0,0,0,0,0,0,0,0
Swansea City,2010-11,2011,0,0,0,0,0,0,0,0
Swansea City,2003-04,2004,0,0,0,0,0,0,0,0
Swansea City,2007-08,2008,0,0,0,0,0,0,0,0
Swansea City,1995-96,1996,0,0,0,0,0,0,0,0
Swansea City,2015-16,2016,47,238,42,233,52,257,-10,-24
Swansea City,1996-97,1997,0,0,0,0,0,0,0,0
Swansea City,2005-06,2006,0,0,0,0,0,0,0,0
Swansea City,1992-93,1993,0,0,0,0,0,0,0,0
Swansea City,2017-18,2018,33,312,28,306,56,383,-28,-77
Swansea City,2021-22,2022,0,312,0,306,0,383,0,-77
Swansea City,2012-13,2013,46,93,47,91,51,102,-4,-11
Swansea City,1993-94,1994,0,0,0,0,0,0,0,0
Swansea City,2004-05,2005,0,0,0,0,0,0,0,0
Swansea City,2008-09,2009,0,0,0,0,0,0,0,0
Swansea City,1994-95,1995,0,0,0,0,0,0,0,0
Swansea City,1999-00,2000,0,0,0,0,0,0,0,0
Swansea City,2020-21,2021,0,312,0,306,0,383,0,-77
Swansea City,2009-10,2010,0,0,0,0,0,0,0,0
Swansea City,2000-01,2001,0,0,0,0,0,0,0,0
Swansea City,2013-14,2014,42,135,54,145,54,156,0,-11
Swansea City,2001-02,2002,0,0,0,0,0,0,0,0
Swansea City,1997-98,1998,0,0,0,0,0,0,0,0
Swansea City,2019-20,2020,0,312,0,306,0,383,0,-77
Swansea City,2006-07,2007,0,0,0,0,0,0,0,0
Swansea City,2022-23,2023,0,312,0,306,0,383,0,-77
Swansea City,2011-12,2012,47,47,44,44,51,51,-7,-7
Swansea City,2018-19,2019,0,312,0,306,0,383,0,-77
Swansea City,2014-15,2015,56,191,46,191,49,205,-3,-14
Swansea City,2016-17,2017,41,279,45,278,70,327,-25,-49
Swansea City,1998-99,1999,0,0,0,0,0,0,0,0
Swansea City,2023-24,2024,0,312,0,306,0,383,0,-77
Oldham Athletic,2002-03,2003,0,89,0,105,0,142,0,-37
Oldham Athletic,2010-11,2011,0,89,0,105,0,142,0,-37
Oldham Athletic,2003-04,2004,0,89,0,105,0,142,0,-37
Oldham Athletic,2007-08,2008,0,89,0,105,0,142,0,-37
Oldham Athletic,1995-96,1996,0,89,0,105,0,142,0,-37
Oldham Athletic,2015-16,2016,0,89,0,105,0,142,0,-37
Oldham Athletic,1996-97,1997,0,89,0,105,0,142,0,-37
Oldham Athletic,2005-06,2006,0,89,0,105,0,142,0,-37
Oldham Athletic,1992-93,1993,49,49,63,63,74,74,-11,-11
Oldham Athletic,2017-18,2018,0,89,0,105,0,142,0,-37
Oldham Athletic,2021-22,2022,0,89,0,105,0,142,0,-37
Oldham Athletic,2012-13,2013,0,89,0,105,0,142,0,-37
Oldham Athletic,1993-94,1994,40,89,42,105,68,142,-26,-37
Oldham Athletic,2004-05,2005,0,89,0,105,0,142,0,-37
Oldham Athletic,2008-09,2009,0,89,0,105,0,142,0,-37
Oldham Athletic,1994-95,1995,0,89,0,105,0,142,0,-37
Oldham Athletic,1999-00,2000,0,89,0,105,0,142,0,-37
Oldham Athletic,2020-21,2021,0,89,0,105,0,142,0,-37
Oldham Athletic,2009-10,2010,0,89,0,105,0,142,0,-37
Oldham Athletic,2000-01,2001,0,89,0,105,0,142,0,-37
Oldham Athletic,2013-14,2014,0,89,0,105,0,142,0,-37
Oldham Athletic,2001-02,2002,0,89,0,105,0,142,0,-37
Oldham Athletic,1997-98,1998,0,89,0,105,0,142,0,-37
Oldham Athletic,2019-20,2020,0,89,0,105,0,142,0,-37
Oldham Athletic,2006-07,2007,0,89,0,105,0,142,0,-37
Oldham Athletic,2022-23,2023,0,89,0,105,0,142,0,-37
Oldham Athletic,2011-12,2012,0,89,0,105,0,142,0,-37
Oldham Athletic,2018-19,2019,0,89,0,105,0,142,0,-37
Oldham Athletic,2014-15,2015,0,89,0,105,0,142,0,-37
Oldham Athletic,2016-17,2017,0,89,0,105,0,142,0,-37
Oldham Athletic,1998-99,1999,0,89,0,105,0,142,0,-37
Oldham Athletic,2023-24,2024,0,89,0,105,0,142,0,-37
Fulham,2002-03,2003,48,92,41,77,50,94,-9,-17
Fulham,2010-11,2011,49,459,49,432,43,501,6,-69
Fulham,2003-04,2004,52,144,52,129,46,140,6,-11
Fulham,2007-08,2008,36,311,38,305,60,378,-22,-73
Fulham,1995-96,1996,0,0,0,0,0,0,0,0
Fulham,2015-16,2016,0,586,0,570,0,697,0,-127
Fulham,1996-97,1997,0,0,0,0,0,0,0,0
Fulham,2005-06,2006,48,236,48,229,58,258,-10,-29
Fulham,1992-93,1993,0,0,0,0,0,0,0,0
Fulham,2017-18,2018,0,586,0,570,0,697,0,-127
Fulham,2021-22,2022,0,640,0,631,0,831,0,-200
Fulham,2012-13,2013,43,554,50,530,60,612,-10,-82
Fulham,1993-94,1994,0,0,0,0,0,0,0,0
Fulham,2004-05,2005,44,188,52,181,60,200,-8,-19
Fulham,2008-09,2009,53,364,39,344,34,412,5,-68
Fulham,1994-95,1995,0,0,0,0,0,0,0,0
Fulham,1999-00,2000,0,0,0,0,0,0,0,0
Fulham,2020-21,2021,28,640,27,631,53,831,-26,-200
Fulham,2009-10,2010,46,410,39,383,46,458,-7,-75
Fulham,2000-01,2001,0,0,0,0,0,0,0,0
Fulham,2013-14,2014,32,586,40,570,85,697,-45,-127
Fulham,2001-02,2002,44,44,36,36,44,44,-8,-8
Fulham,1997-98,1998,0,0,0,0,0,0,0,0
Fulham,2019-20,2020,0,612,0,604,0,778,0,-174
Fulham,2006-07,2007,39,275,38,267,60,318,-22,-51
Fulham,2022-23,2023,52,692,55,686,53,884,2,-198
Fulham,2011-12,2012,52,511,48,480,51,552,-3,-72
Fulham,2018-19,2019,26,612,34,604,81,778,-47,-174
Fulham,2014-15,2015,0,586,0,570,0,697,0,-127
Fulham,2016-17,2017,0,586,0,570,0,697,0,-127
Fulham,1998-99,1999,0,0,0,0,0,0,0,0
Fulham,2023-24,2024,47,739,55,741,61,945,-6,-204
